FORMA	LEMMA	CATEGORIA
abate	abate	ecclesiastical occupation
abati	abate	ecclesiastical occupation
abatina	abate	ecclesiastical occupation
abatine	abate	ecclesiastical occupation
abatini	abate	ecclesiastical occupation
abatino	abate	ecclesiastical occupation
abatucci	abate	ecclesiastical occupation
abatuccio	abate	ecclesiastical occupation
abbadessa	abate	ecclesiastical occupation
abbadesse	abate	ecclesiastical occupation
accademica	accademico	profession
accademiche	accademico	profession
accademici	accademico	profession
accademico	accademico	profession
accalappiacani	accalappiacani	profession
accolita	accolito	ecclesiastical occupation
accolite	accolito	ecclesiastical occupation
accoliti	accolito	ecclesiastical occupation
accolito	accolito	ecclesiastical occupation
accompagnatora	accompagnatore	profession
accompagnatore	accompagnatore	profession
accompagnatoressa	accompagnatore	profession
accompagnatoresse	accompagnatore	profession
accompagnatori	accompagnatore	profession
accompagnatrice	accompagnatore	profession
accompagnatrici	accompagnatore	profession
accordatora	accordatore	profession
accordatore	accordatore	profession
accordatoressa	accordatore	profession
accordatoresse	accordatore	profession
accordatori	accordatore	profession
accordatrice	accordatore	profession
accordatrici	accordatore	profession
acquafortista	acquafortista	profession
acquafortiste	acquafortista	profession
acquafortisti	acquafortista	profession
acquaiola	acquaiolo	profession
acquaiole	acquaiolo	profession
acquaioli	acquaiolo	profession
acquaiolo	acquaiolo	profession
acquerellista	acquerellista	profession
acquerelliste	acquerellista	profession
acquerellisti	acquerellista	profession
acrobata	acrobata	profession
acrobate	acrobata	profession
acrobati	acrobata	profession
adelantadi	adelantado	profession
adelantado	adelantado	profession
aedi	aedo	profession
aedo	aedo	profession
affrescatora	affrescatore	profession
affrescatore	affrescatore	profession
affrescatoressa	affrescatore	profession
affrescatoresse	affrescatore	profession
affrescatori	affrescatore	profession
affrescatrice	affrescatore	profession
affrescatrici	affrescatore	profession
agente	agente	profession
agenti	agente	profession
agrimensora	agrimensore	profession
agrimensore	agrimensore	profession
agrimensoressa	agrimensore	profession
agrimensoresse	agrimensore	profession
agrimensori	agrimensore	profession
agronomi	agronomo	profession
agronomo	agronomo	profession
aiutante	aiutante	military rank
aiutanti	aiutante	military rank
albergatora	albergatore	profession
albergatore	albergatore	profession
albergatoressa	albergatore	profession
albergatoresse	albergatore	profession
albergatori	albergatore	profession
albergatrice	albergatore	profession
albergatrici	albergatore	profession
alchimista	alchimista	profession
alchimiste	alchimista	profession
alchimisti	alchimista	profession
alfiera	alfiere	military rank
alfiere	alfiere	military rank
alfieri	alfiere	military rank
algebrista	algebrista	profession
algebriste	algebrista	profession
algebristi	algebrista	profession
alienista	alienista	profession
alieniste	alienista	profession
alienisti	alienista	profession
allenatora	allenatore	profession
allenatore	allenatore	profession
allenatoressa	allenatore	profession
allenatoresse	allenatore	profession
allenatori	allenatore	profession
allenatrice	allenatore	profession
allenatrici	allenatore	profession
allevatora	allevatore	profession
allevatore	allevatore	profession
allevatori	allevatore	profession
allevatrice	allevatore	profession
allevatrici	allevatore	profession
alpini	alpino	military rank
alpinista	alpinista	profession
alpiniste	alpinista	profession
alpinisti	alpinista	profession
alpino	alpino	military rank
alunna	alunno	military rank
alunne	alunno	military rank
alunni	alunno	military rank
alunno	alunno	military rank
amanuense	amanuense	profession
amanuensi	amanuense	profession
ambasciatora	ambasciatore	profession
ambasciatore	ambasciatore	profession
ambasciatoressa	ambasciatore	profession
ambasciatoresse	ambasciatore	profession
ambasciatori	ambasciatore	profession
ambasciatrice	ambasciatore	profession
ambasciatrici	ambasciatore	profession
ambulante	ambulante	profession
ambulanti	ambulante	profession
ammaestratora	ammaestratore	profession
ammaestratore	ammaestratore	profession
ammaestratoressa	ammaestratore	profession
ammaestratoresse	ammaestratore	profession
ammaestratori	ammaestratore	profession
ammaestratrice	ammaestratore	profession
ammaestratrici	ammaestratore	profession
ammiraglia	ammiraglio	military rank
ammiraglie	ammiraglio	military rank
ammiraglii	ammiraglio	military rank
ammiraglio	ammiraglio	military rank
analista	analista	profession
analiste	analista	profession
analisti	analista	profession
anatomista	anatomista	profession
anatomiste	anatomista	profession
anatomisti	anatomista	profession
anestesista	anestesista	profession
anestesiste	anestesista	profession
anestesisti	anestesista	profession
animatore	animatore	profession
animatori	animatore	profession
animatrice	animatore	profession
animatrici	animatore	profession
annalista	annalista	profession
annaliste	annalista	profession
annalisti	annalista	profession
annunciatore	annunciatore	profession
annunciatori	annunciatore	profession
annunciatrice	annunciatore	profession
annunciatrici	annunciatore	profession
antiquari	antiquario	profession
antiquaria	antiquario	profession
antiquarie	antiquario	profession
antiquarii	antiquario	profession
antiquario	antiquario	profession
antropologa	antropologo	profession
antropologhe	antropologo	profession
antropologhi	antropologo	profession
antropologi	antropologo	profession
antropologo	antropologo	profession
apologista	apologista	profession
apologiste	apologista	profession
apologisti	apologista	profession
apparatora	apparatore	profession
apparatore	apparatore	profession
apparatoressa	apparatore	profession
apparatoresse	apparatore	profession
apparatori	apparatore	profession
apparatrice	apparatore	profession
apparatrici	apparatore	profession
apprendista	apprendista	profession
apprendiste	apprendista	profession
apprendisti	apprendista	profession
appuntata	appuntato	military rank
appuntate	appuntato	military rank
appuntati	appuntato	military rank
appuntato	appuntato	military rank
arabista	arabista	profession
arabiste	arabista	profession
arabisti	arabista	profession
araldi	araldo	profession
araldo	araldo	profession
aratora	aratore	profession
aratore	aratore	profession
aratoressa	aratore	profession
aratoresse	aratore	profession
aratori	aratore	profession
aratrice	aratore	profession
aratrici	aratore	profession
arbitra	arbitro	profession
arbitre	arbitro	profession
arbitressa	arbitro	profession
arbitri	arbitro	profession
arbitro	arbitro	profession
archeologa	archeologo	profession
archeologhe	archeologo	profession
archeologi	archeologo	profession
archeologo	archeologo	profession
archibugiera	archibugiere	profession
archibugiere	archibugiere	profession
archibugieri	archibugiere	profession
archimandrita	archimandrita	ecclesiastical occupation
archimandrite	archimandrita	ecclesiastical occupation
archimandriti	archimandrita	ecclesiastical occupation
architetta	architetto	profession
architette	architetto	profession
architetti	architetto	profession
architetto	architetto	profession
archivista	archivista	profession
archiviste	archivista	profession
archivisti	archivista	profession
arcidiaconi	arcidiacono	ecclesiastical occupation
arcidiacono	arcidiacono	ecclesiastical occupation
arciduca	arciduca	noble rank
arciduchessa	arciduchessa	noble rank
arciduchesse	arciduchessa	noble rank
arciduchi	arciduca	noble rank
arciera	arciere	profession
arciere	arciere	profession
arcieri	arciere	profession
arciprete	arciprete	ecclesiastical occupation
arcipreti	arciprete	ecclesiastical occupation
arcivescovi	arcivescovo	ecclesiastical occupation
arcivescovo	arcivescovo	ecclesiastical occupation
argentarii	argentario	profession
argentario	argentario	profession
argentiera	argentiere	profession
argentiere	argentiere	profession
argentieri	argentiere	profession
armaioli	armaiolo	profession
armaiolo	armaiolo	profession
armatora	armatore	profession
armatore	armatore	profession
armatoressa	armatore	profession
armatoresse	armatore	profession
armatori	armatore	profession
armatrice	armatore	profession
armatrici	armatore	profession
armiera	armiere	profession
armiere	armiere	profession
armieri	armiere	profession
armorari	armoraro	profession
armoraro	armoraro	profession
aromatarii	aromatario	profession
aromatario	aromatario	profession
arrampicatora	arrampicatore	profession
arrampicatore	arrampicatore	profession
arrampicatoressa	arrampicatore	profession
arrampicatoresse	arrampicatore	profession
arrampicatori	arrampicatore	profession
arrampicatrice	arrampicatore	profession
arrampicatrici	arrampicatore	profession
arrotini	arrotino	profession
arrotino	arrotino	profession
arsenalotti	arsenalotto	profession
arsenalotto	arsenalotto	profession
articolista	articolista	profession
articoliste	articolista	profession
articolisti	articolista	profession
artiera	artiere	profession
artiere	artiere	profession
artieri	artiere	profession
artigiana	artigiano	profession
artigiane	artigiano	profession
artigianelli	artigianello	profession
artigianello	artigianello	profession
artigiani	artigiano	profession
artigiano	artigiano	profession
artigliera	artigliere	profession
artigliere	artigliere	profession
artiglieri	artigliere	profession
aruspice	aruspice	profession
aruspici	aruspice	profession
assaggiatore	assaggiatore	profession
assaggiatori	assaggiatore	profession
assaggiatrice	assaggiatore	profession
assaggiatrici	assaggiatore	profession
assalariata	assalariato	profession
assalariate	assalariato	profession
assalariati	assalariato	profession
assalariato	assalariato	profession
assistente	assistente	military rank
assistenti	assistente	military rank
astrologa	astrologo	profession
astrologhe	astrologo	profession
astrologi	astrologo	profession
astrologo	astrologo	profession
astronoma	astronomo	profession
astronome	astronomo	profession
astronomi	astronomo	profession
astronomo	astronomo	profession
atleta	atleta	profession
atlete	atleta	profession
atleti	atleta	profession
attacchini	attacchino	profession
attacchino	attacchino	profession
attora	attore	profession
attoracce	attore	profession
attoracci	attore	profession
attoraccia	attore	profession
attoraccio	attore	profession
attore	attore	profession
attori	attore	profession
attorina	attore	profession
attorine	attore	profession
attorini	attore	profession
attorino	attore	profession
attorucoli	attore	profession
attorucolo	attore	profession
attrezzista	attrezzista	profession
attrezziste	attrezzista	profession
attrezzisti	attrezzista	profession
attricetta	attore	profession
attrici	attore	profession
attuari	attuario	profession
attuaria	attuario	profession
attuarie	attuario	profession
attuarii	attuario	profession
attuario	attuario	profession
auriga	auriga	profession
aurighe	auriga	profession
aurighi	auriga	profession
autista	autista	profession
autiste	autista	profession
autisti	autista	profession
automobilista	automobilista	profession
automobiliste	automobilista	profession
automobilisti	automobilista	profession
autora	autore	profession
autore	autore	profession
autoressa	autore	profession
autoresse	autore	profession
autori	autore	profession
autrice	autore	profession
autrici	autore	profession
aviatora	aviatore	profession
aviatore	aviatore	profession
aviatoressa	aviatore	profession
aviatoresse	aviatore	profession
aviatori	aviatore	profession
aviatrice	aviatore	profession
aviatrici	aviatore	profession
avvocata	avvocato	profession
avvocatacce	avvocato	profession
avvocatacci	avvocato	profession
avvocataccia	avvocato	profession
avvocataccio	avvocato	profession
avvocate	avvocato	profession
avvocatessa	avvocato	profession
avvocatesse	avvocato	profession
avvocati	avvocato	profession
avvocatina	avvocato	profession
avvocatine	avvocato	profession
avvocatini	avvocato	profession
avvocatino	avvocato	profession
avvocato	avvocato	profession
avvocatona	avvocato	profession
avvocatone	avvocato	profession
avvocatoni	avvocato	profession
avvocatucce	avvocato	profession
avvocatucci	avvocato	profession
avvocatuccia	avvocato	profession
avvocatuccio	avvocato	profession
avvocatucola	avvocato	profession
avvocatucole	avvocato	profession
avvocatucoli	avvocato	profession
avvocatucolo	avvocato	profession
bacai	bacaio	profession
bacaia	bacaio	profession
bacaie	bacaio	profession
bacaio	bacaio	profession
bacaj	bacaio	profession
bacaja	bacaio	profession
bacaje	bacaio	profession
bacaji	bacaio	profession
bacajo	bacaio	profession
baccellai	baccellaio	profession
baccellaia	baccellaio	profession
baccellaie	baccellaio	profession
baccellaio	baccellaio	profession
baccellaj	baccellaio	profession
baccellaja	baccellaio	profession
baccellaje	baccellaio	profession
baccellaji	baccellaio	profession
baccellajo	baccellaio	profession
badessa	badessa	ecclesiastical occupation
badesse	badessa	ecclesiastical occupation
bagattelliera	bagattelliere	profession
bagattelliere	bagattelliere	profession
bagattellieri	bagattelliere	profession
bagnina	bagnino	profession
bagnine	bagnino	profession
bagnini	bagnino	profession
bagnino	bagnino	profession
baleniera	baleniere	profession
baleniere	baleniere	profession
balenieri	baleniere	profession
balestriera	balestriere	profession
balestriere	balestriere	profession
balestrieri	balestriere	profession
bali	balio	profession
balia	balio	profession
balie	balio	profession
balietta	balio	profession
baliette	balio	profession
balietti	balio	profession
balietto	balio	profession
balii	balio	profession
balio	balio	profession
ballerina	ballerino	profession
ballerine	ballerino	profession
ballerini	ballerino	profession
ballerino	ballerino	profession
bambinai	bambinaia	profession
bambinaia	bambinaia	profession
bambinaie	bambinaia	profession
bambinaio	bambinaia	profession
bambinaj	bambinaia	profession
bambinaja	bambinaia	profession
bambinaje	bambinaia	profession
bambinaji	bambinaia	profession
bambinajo	bambinaia	profession
bancari	bancario	profession
bancaria	bancario	profession
bancarie	bancario	profession
bancarii	bancario	profession
bancario	bancario	profession
banchiera	banchiere	profession
banchiere	banchiere	profession
banchieri	banchiere	profession
banderai	banderaio	profession
banderai	banderaio	profession
banderaia	banderaio	profession
banderaie	banderaio	profession
banderaio	banderaio	profession
banderaj	banderaio	profession
banderaja	banderaio	profession
banderaje	banderaio	profession
banderaji	banderaio	profession
banderajo	banderaio	profession
banderilleri	banderillero	profession
banderillero	banderillero	profession
bandierai	bandieraio	profession
bandieraia	bandieraio	profession
bandieraie	bandieraio	profession
bandieraio	bandieraio	profession
bandieraj	bandieraio	profession
bandieraja	bandieraio	profession
bandieraje	bandieraio	profession
bandieraji	bandieraio	profession
bandierajo	bandieraio	profession
bandista	bandista	profession
bandiste	bandista	profession
bandisti	bandista	profession
banditora	banditore	profession
banditore	banditore	profession
banditoressa	banditore	profession
banditoresse	banditore	profession
banditori	banditore	profession
banditrice	banditore	profession
banditrici	banditore	profession
barbiera	barbiere	profession
barbiere	barbiere	profession
barbieri	barbiere	profession
barbierina	barbiere	profession
barbierine	barbiere	profession
barbierini	barbiere	profession
barbierino	barbiere	profession
barcaiola	barcaiolo	profession
barcaiole	barcaiolo	profession
barcaioli	barcaiolo	profession
barcaiolo	barcaiolo	profession
barcajola	barcaiolo	profession
barcajole	barcaiolo	profession
barcajoli	barcaiolo	profession
barcajolo	barcaiolo	profession
barda	bardo	profession
barde	bardo	profession
bardi	bardo	profession
bardina	bardo	profession
bardine	bardo	profession
bardini	bardo	profession
bardino	bardo	profession
bardo	bardo	profession
barista	barista	profession
bariste	barista	profession
baristi	barista	profession
barnabita	barnabita	ecclesiastical occupation
barnabite	barnabita	ecclesiastical occupation
barnabiti	barnabita	ecclesiastical occupation
barocciai	barocciaio	profession
barocciaia	barocciaio	profession
barocciaie	barocciaio	profession
barocciaio	barocciaio	profession
barocciaj	barocciaio	profession
barocciaja	barocciaio	profession
barocciaje	barocciaio	profession
barocciaji	barocciaio	profession
barocciajo	barocciaio	profession
baroncini	barone	noble rank
baroncino	barone	noble rank
barone	barone	noble rank
baronessa	baronessa	noble rank
baronesse	baronessa	noble rank
baronessina	baronessa	noble rank
baronessine	baronessa	noble rank
baroni	barone	noble rank
barrocciai	barrocciaio	profession
barrocciaia	barrocciaio	profession
barrocciaie	barrocciaio	profession
barrocciaio	barrocciaio	profession
barrocciaj	barrocciaio	profession
barrocciaja	barrocciaio	profession
barrocciaje	barrocciaio	profession
barrocciaji	barrocciaio	profession
barrocciajo	barrocciaio	profession
basileus	basileus	noble rank
battelliera	battelliere	profession
battelliere	battelliere	profession
battellieri	battelliere	profession
batteriologa	batteriologo	profession
batteriologhe	batteriologo	profession
batteriologhi	batteriologo	profession
batteriologi	batteriologo	profession
batteriologo	batteriologo	profession
battilani	battilano	profession
battilano	battilano	profession
battilori	battiloro	profession
battiloro	battiloro	profession
battimazza	battimazza	profession
battimazze	battimazza	profession
beccai	beccaio	profession
beccaia	beccaio	profession
beccaie	beccaio	profession
beccaio	beccaio	profession
beccaj	beccaio	profession
beccaja	beccaio	profession
beccaje	beccaio	profession
beccaji	beccaio	profession
beccajo	beccaio	profession
beccamorti	beccamorto	profession
beccamorto	beccamorto	profession
becchini	becchino	profession
becchino	becchino	profession
bergamina	bergamino	profession
bergamine	bergamino	profession
bergamini	bergamino	profession
bergamino	bergamino	profession
berrettai	berrettaio	profession
berrettaia	berrettaio	profession
berrettaie	berrettaio	profession
berrettaio	berrettaio	profession
berrettaj	berrettaio	profession
berrettaja	berrettaio	profession
berrettaje	berrettaio	profession
berrettaji	berrettaio	profession
berrettajo	berrettaio	profession
bestiari	bestiario	profession
bestiarii	bestiario	profession
bestiario	bestiario	profession
bettolante	bettolante	profession
bettolanti	bettolante	profession
bettoliera	bettoliere	profession
bettoliere	bettoliere	profession
bettolieri	bettoliere	profession
bibliografa	bibliografo	profession
bibliografe	bibliografo	profession
bibliografi	bibliografo	profession
bibliografo	bibliografo	profession
bibliotecari	bibliotecario	profession
bibliotecaria	bibliotecario	profession
bibliotecarie	bibliotecario	profession
bibliotecarii	bibliotecario	profession
bibliotecario	bibliotecario	profession
bidella	bidello	profession
bidelle	bidello	profession
bidelli	bidello	profession
bidello	bidello	profession
bigattiera	bigattiere	profession
bigattiere	bigattiere	profession
bigattieri	bigattiere	profession
biografa	biografo	profession
biografe	biografo	profession
biografi	biografo	profession
biografo	biografo	profession
biologa	biologo	profession
biologhe	biologo	profession
biologi	biologo	profession
biologhi	biologo	profession
biologo	biologo	profession
birrai	birraio	profession
birraia	birraio	profession
birraie	birraio	profession
birraio	birraio	profession
birraj	birraio	profession
birraja	birraio	profession
birraje	birraio	profession
birraji	birraio	profession
birrajo	birraio	profession
boara	boaro	profession
boare	boaro	profession
boari	boaro	profession
boarina	boaro	profession
boarine	boaro	profession
boarini	boaro	profession
boaro	boaro	profession
boia	boia	profession
boiardi	boiardo	noble rank
boiardo	boiardo	noble rank
bombardiera	bombardiere	military rank
bombardiere	bombardiere	military rank
bombardieri	bombardiere	military rank
bordonari	bordonaro	profession
bordonaro	bordonaro	profession
borgomastri	borgomastro	profession
borgomastro	borgomastro	profession
borsista	borsista	profession
borsiste	borsista	profession
borsisti	borsista	profession
boscaiola	boscaiolo	profession
boscaiole	boscaiolo	profession
boscaioli	boscaiolo	profession
boscaiolo	boscaiolo	profession
botanica	botanico	profession
botaniche	botanico	profession
botanici	botanico	profession
botanico	botanico	profession
bottai	bottaio	profession
bottaia	bottaio	profession
bottaie	bottaio	profession
bottaio	bottaio	profession
bottaj	bottaio	profession
bottaja	bottaio	profession
bottaje	bottaio	profession
bottaji	bottaio	profession
bottajo	bottaio	profession
bottegai	bottegaio	profession
bottegaia	bottegaio	profession
bottegaie	bottegaio	profession
bottegaio	bottegaio	profession
bottegaj	bottegaio	profession
bottegaja	bottegaio	profession
bottegaje	bottegaio	profession
bottegaji	bottegaio	profession
bottegajo	bottegaio	profession
bottigliera	bottigliere	profession
bottigliere	bottigliere	profession
bottiglieri	bottigliere	profession
bouquiniste	bouquiniste	profession
bouquinisti	bouquiniste	profession
bovari	bovaro	profession
bovaro	bovaro	profession
bracciante	bracciante	profession
braccianti	bracciante	profession
bracina	bracino	profession
bracine	bracino	profession
bracini	bracino	profession
bracino	bracino	profession
brentatora	brentatore	profession
brentatore	brentatore	profession
brentatoressa	brentatore	profession
brentatoresse	brentatore	profession
brentatori	brentatore	profession
brentatrice	brentatore	profession
brentatrici	brentatore	profession
brigadiera	brigadiere	military rank
brigadiere	brigadiere	military rank
brigadieri	brigadiere	military rank
brumista	brumista	profession
brumiste	brumista	profession
brumisti	brumista	profession
buffona	buffone	profession
buffone	buffone	profession
buffoni	buffone	profession
buonavoglia	buonavoglia	profession
buonavoglie	buonavoglia	profession
buonavoglii	buonavoglia	profession
burattinai	burattinaio	profession
burattinaia	burattinaio	profession
burattinaie	burattinaio	profession
burattinaio	burattinaio	profession
burattinaj	burattinaio	profession
burattinaja	burattinaio	profession
burattinaje	burattinaio	profession
burattinaji	burattinaio	profession
burattinajo	burattinaio	profession
burocrate	burocrate	profession
burocrati	burocrate	profession
bustai	bustaio	profession
bustaia	bustaio	profession
bustaie	bustaio	profession
bustaio	bustaio	profession
bustaj	bustaio	profession
bustaja	bustaio	profession
bustaje	bustaio	profession
bustaji	bustaio	profession
bustajo	bustaio	profession
butteretta	buttero	profession
butterette	buttero	profession
butteretti	buttero	profession
butteretto	buttero	profession
butteri	buttero	profession
b첫tteri	b첫ttero	profession
buttero	buttero	profession
b첫ttero	b첫ttero	profession
cabalista	cabalista	profession
cabaliste	cabalista	profession
cabalisti	cabalista	profession
cabi	cabo	military rank
cabo	cabo	military rank
cacciatora	cacciatore	profession
cacciatore	cacciatore	profession
cacciatoressa	cacciatore	profession
cacciatoresse	cacciatore	profession
cacciatori	cacciatore	profession
cacciatrice	cacciatore	profession
cacciatrici	cacciatore	profession
caffettiera	caffettiere	profession
caffettiere	caffettiere	profession
caffettieri	caffettiere	profession
caffettierina	caffettiere	profession
caffettierine	caffettiere	profession
caffettierini	caffettiere	profession
calafata	calafato	profession
calafate	calafato	profession
calafati	calafato	profession
calafato	calafato	profession
calciatora	calciatore	profession
calciatore	calciatore	profession
calciatoressa	calciatore	profession
calciatoresse	calciatore	profession
calciatori	calciatore	profession
calciatrice	calciatore	profession
calciatrici	calciatore	profession
calcinai	calcinaio	profession
calcinaia	calcinaio	profession
calcinaie	calcinaio	profession
calcinaio	calcinaio	profession
calcinaj	calcinaio	profession
calcinaja	calcinaio	profession
calcinaje	calcinaio	profession
calcinaji	calcinaio	profession
calcinajo	calcinaio	profession
calcolatora	calcolatore	profession
calcolatore	calcolatore	profession
calcolatoressa	calcolatore	profession
calcolatoresse	calcolatore	profession
calcolatori	calcolatore	profession
calcolatrice	calcolatore	profession
calcolatrici	calcolatore	profession
calderai	calderaio	profession
calderaia	calderaio	profession
calderaie	calderaio	profession
calderaio	calderaio	profession
calderaj	calderaio	profession
calderaja	calderaio	profession
calderaje	calderaio	profession
calderaji	calderaio	profession
calderajo	calderaio	profession
calligrafa	calligrafo	profession
calligrafe	calligrafo	profession
calligrafi	calligrafo	profession
calligrafo	calligrafo	profession
calzaioli	calzaiolo	profession
calzaiolo	calzaiolo	profession
calzajoli	calzaiolo	profession
calzajolo	calzaiolo	profession
calzettai	calzettaio	profession
calzettaia	calzettaio	profession
calzettaie	calzettaio	profession
calzettaio	calzettaio	profession
calzettaj	calzettaio	profession
calzettaja	calzettaio	profession
calzettaje	calzettaio	profession
calzettaji	calzettaio	profession
calzettajo	calzettaio	profession
camalli	camallo	profession
camallo	camallo	profession
cambiamonete	cambiamonete	profession
cambiamoneti	cambiamonete	profession
cambiatora	cambiatore	profession
cambiatore	cambiatore	profession
cambiatoressa	cambiatore	profession
cambiatoresse	cambiatore	profession
cambiatori	cambiatore	profession
cambiatrice	cambiatore	profession
cambiatrici	cambiatore	profession
cambiavalute	cambiavalute	profession
cambiavaluti	cambiavalute	profession
cambista	cambista	profession
cambiste	cambista	profession
cambisti	cambista	profession
cameriera	cameriere	profession
camerieracce	cameriere	profession
camerieracci	cameriere	profession
camerieraccia	cameriere	profession
camerieraccio	cameriere	profession
cameriere	cameriere	profession
camerieretta	cameriere	profession
camerierette	cameriere	profession
camerieretti	cameriere	profession
camerieri	cameriere	profession
camerierina	cameriere	profession
camerierine	cameriere	profession
camerierini	cameriere	profession
camerista	camerista	profession
cameriste	camerista	profession
cameristi	camerista	profession
camerotti	camerotto	profession
camerotto	camerotto	profession
camiciai	camiciaio	profession
camiciaia	camiciaio	profession
camiciaie	camiciaio	profession
camiciaio	camiciaio	profession
camiciaj	camiciaio	profession
camiciaja	camiciaio	profession
camiciaje	camiciaio	profession
camiciaji	camiciaio	profession
camiciajo	camiciaio	profession
cammelliera	cammelliere	profession
cammelliere	cammelliere	profession
cammellieri	cammelliere	profession
campanai	campanaio	profession
campanaia	campanaio	profession
campanaie	campanaio	profession
campanaio	campanaio	profession
campanaj	campanaio	profession
campanaja	campanaio	profession
campanaje	campanaio	profession
campanaji	campanaio	profession
campanajo	campanaio	profession
campanari	campanaro	profession
campanaro	campanaro	profession
campara	camparo	profession
campari	camparo	profession
camparina	camparo	profession
camparine	camparo	profession
camparini	camparo	profession
camparino	camparo	profession
camparo	camparo	profession
campiera	campiere	profession
campiere	campiere	profession
campieri	campiere	profession
canapai	canapaio	profession
canapaia	canapaio	profession
canapaie	canapaio	profession
canapaio	canapaio	profession
canapaj	canapaio	profession
canapaja	canapaio	profession
canapaje	canapaio	profession
canapaji	canapaio	profession
canapajo	canapaio	profession
canattiera	canattiere	profession
canattiere	canattiere	profession
canattieri	canattiere	profession
cancelliera	cancelliere	ecclesiastical occupation
cancelliere	cancelliere	ecclesiastical occupation
cancellieri	cancelliere	ecclesiastical occupation
candelai	candelaio	profession
candelaia	candelaio	profession
candelaie	candelaio	profession
candelaio	candelaio	profession
candelaj	candelaio	profession
candelaja	candelaio	profession
candelaje	candelaio	profession
candelaji	candelaio	profession
candelajo	candelaio	profession
canestrai	canestraio	profession
canestraia	canestraio	profession
canestraie	canestraio	profession
canestraio	canestraio	profession
canestraj	canestraio	profession
canestraja	canestraio	profession
canestraje	canestraio	profession
canestraji	canestraio	profession
canestrajo	canestraio	profession
canonica	canonico	ecclesiastical occupation
canoniche	canonico	ecclesiastical occupation
canonichessa	canonichessa	ecclesiastical occupation
canonichesse	canonichessa	ecclesiastical occupation
canonici	canonico	ecclesiastical occupation
canonico	canonico	ecclesiastical occupation
canovai	canovaio	profession
canovaia	canovaio	profession
canovaie	canovaio	profession
canovaio	canovaio	profession
canovaj	canovaio	profession
canovaja	canovaio	profession
canovaje	canovaio	profession
canovaji	canovaio	profession
canovajo	canovaio	profession
cantastorie	cantastorie	profession
cantastorii	cantastorie	profession
cantiniera	cantiniere	profession
cantiniere	cantiniere	profession
cantinieri	cantiniere	profession
cantoniera	cantoniere	profession
cantoniere	cantoniere	profession
cantonieri	cantoniere	profession
cantora	cantore	profession
cantore	cantore	profession
cantoressa	cantore	profession
cantoresse	cantore	profession
cantori	cantore	profession
cantorina	cantore	profession
cantorine	cantore	profession
cantorini	cantore	profession
cantorino	cantore	profession
cantrice	cantore	profession
capicuoco	capocuoco	profession
capimaestro	capomaestro	profession
capimanipolo	capomanipolo	military rank
capimastro	capomastro	profession
capisquadrone	caposquadrone	military rank
capistazione	capostazione	profession
capitana	capitano	military rank
capitane	capitano	military rank
capitanessa	capitano	military rank
capitanesse	capitano	military rank
capitani	capitano	military rank
capitanina	capitano	military rank
capitanine	capitano	military rank
capitanini	capitano	military rank
capitanino	capitano	military rank
capitano	capitano	military rank
capitanucce	capitano	military rank
capitanucci	capitano	military rank
capitanuccia	capitano	military rank
capitanuccio	capitano	military rank
capitreno	capotreno	profession
capiturno	capoturno	profession
capizezione	caposezione	profession
capocomica	capocomico	profession
capocomiche	capocomico	profession
capocomici	capocomico	profession
capocomico	capocomico	profession
capocuoco	capocuoco	profession
capomaestro	capomaestro	profession
capomanipolo	capomanipolo	military rank
capomastro	capomastro	profession
caporale	caporale	military rank
caporalessa	caporale	military rank
caporalesse	caporale	military rank
caporaletta	caporale	military rank
caporalette	caporale	military rank
caporaletti	caporale	military rank
caporaletto	caporale	military rank
caporali	caporale	military rank
caporalina	caporale	military rank
caporaline	caporale	military rank
caporalini	caporale	military rank
caporalino	caporale	military rank
caporalona	caporale	military rank
caporalone	caporale	military rank
caporaloni	caporale	military rank
caporalucce	caporale	military rank
caporalucci	caporale	military rank
caporaluccia	caporale	military rank
caporaluccio	caporale	military rank
caposezione	caposezione	profession
caposquadrone	caposquadrone	military rank
capostazione	capostazione	profession
capotreno	capotreno	profession
capoturno	capoturno	profession
cappellai	cappellaio	profession
cappellaia	cappellaio	profession
cappellaie	cappellaio	profession
cappellaio	cappellaio	profession
cappellaj	cappellaio	profession
cappellaja	cappellaio	profession
cappellaje	cappellaio	profession
cappellaji	cappellaio	profession
cappellajo	cappellaio	profession
cappuccina	cappuccino	ecclesiastical occupation
cappuccine	cappuccino	ecclesiastical occupation
cappuccini	cappuccino	ecclesiastical occupation
cappuccino	cappuccino	ecclesiastical occupation
caprai	capraio	profession
capraia	capraio	profession
capraie	capraio	profession
capraio	capraio	profession
capraj	capraio	profession
capraja	capraio	profession
capraje	capraio	profession
capraji	capraio	profession
caprajo	capraio	profession
caprari	capraro	profession
capraro	capraro	profession
carabiniera	carabiniere	profession
carabiniere	carabiniere	profession
carabinieri	carabiniere	profession
carbonai	carbonaio	profession
carbonaia	carbonaio	profession
carbonaie	carbonaio	profession
carbonaio	carbonaio	profession
carbonaj	carbonaio	profession
carbonaja	carbonaio	profession
carbonaje	carbonaio	profession
carbonaji	carbonaio	profession
carbonajo	carbonaio	profession
carbonara	carbonaro	profession
carbonare	carbonaro	profession
carbonaretta	carbonaro	profession
carbonarette	carbonaro	profession
carbonaretti	carbonaro	profession
carbonaretto	carbonaro	profession
carbonari	carbonaro	profession
carbonaro	carbonaro	profession
carboniera	carboniere	profession
carboniere	carboniere	profession
carbonieri	carboniere	profession
carceriera	carceriere	profession
carceriere	carceriere	profession
carcerieri	carceriere	profession
cardatora	cardatore	profession
cardatore	cardatore	profession
cardatoressa	cardatore	profession
cardatoresse	cardatore	profession
cardatori	cardatore	profession
cardatrice	cardatore	profession
cardatrici	cardatore	profession
cardinalastri	cardinale	ecclesiastical occupation
cardinalastro	cardinale	ecclesiastical occupation
cardinale	cardinale	ecclesiastical occupation
cardinaletti	cardinale	ecclesiastical occupation
cardinaletto	cardinale	ecclesiastical occupation
cardinali	cardinale	ecclesiastical occupation
cardinalino	cardinale	ecclesiastical occupation
cardinalucci	cardinale	ecclesiastical occupation
cardinaluccio	cardinale	ecclesiastical occupation
caricatora	caricatore	profession
caricatore	caricatore	profession
caricatoressa	caricatore	profession
caricatoresse	caricatore	profession
caricatori	caricatore	profession
caricatrice	caricatore	profession
caricatrici	caricatore	profession
caricaturista	caricaturista	profession
caricaturiste	caricaturista	profession
caricaturisti	caricaturista	profession
carovaniera	carovaniere	profession
carovaniere	carovaniere	profession
carovanieri	carovaniere	profession
carpentiera	carpentiere	profession
carpentiere	carpentiere	profession
carpentieri	carpentiere	profession
carradessa	carradore	profession
carradesse	carradore	profession
carradora	carradore	profession
carradore	carradore	profession
carradoressa	carradore	profession
carradoresse	carradore	profession
carradori	carradore	profession
carrai	carraio	profession
carraia	carraio	profession
carraie	carraio	profession
carraio	carraio	profession
carraj	carraio	profession
carraja	carraio	profession
carraje	carraio	profession
carraji	carraio	profession
carrajo	carraio	profession
carrettai	carrettaio	profession
carrettaia	carrettaio	profession
carrettaie	carrettaio	profession
carrettaio	carrettaio	profession
carrettaj	carrettaio	profession
carrettaja	carrettaio	profession
carrettaje	carrettaio	profession
carrettaji	carrettaio	profession
carrettajo	carrettaio	profession
carrettiera	carrettiere	profession
carrettiere	carrettiere	profession
carrettieri	carrettiere	profession
carriolante	carriolante	profession
carriolanti	carriolante	profession
carrozzai	carrozzaio	profession
carrozzaia	carrozzaio	profession
carrozzaie	carrozzaio	profession
carrozzaio	carrozzaio	profession
carrozzaj	carrozzaio	profession
carrozzaja	carrozzaio	profession
carrozzaje	carrozzaio	profession
carrozzaji	carrozzaio	profession
carrozzajo	carrozzaio	profession
carrozziera	carrozziere	profession
carrozziere	carrozziere	profession
carrozzieri	carrozziere	profession
cartografa	cartografo	profession
cartografe	cartografo	profession
cartografi	cartografo	profession
cartografo	cartografo	profession
cartolai	cartolaio	profession
cartolaia	cartolaio	profession
cartolaie	cartolaio	profession
cartolaio	cartolaio	profession
cartolaj	cartolaio	profession
cartolaja	cartolaio	profession
cartolaje	cartolaio	profession
cartolaji	cartolaio	profession
cartolajo	cartolaio	profession
cartolari	cartolaro	profession
cartolaro	cartolaro	profession
casalinga	casalinga	profession
casalinghe	casalinga	profession
casalinghi	casalinga	profession
casalingo	casalinga	profession
casara	casaro	profession
casari	casaro	profession
casaro	casaro	profession
cascinai	cascinaio	profession
cascinaia	cascinaio	profession
cascinaie	cascinaio	profession
cascinaio	cascinaio	profession
cascinaj	cascinaio	profession
cascinaja	cascinaio	profession
cascinaje	cascinaio	profession
cascinaji	cascinaio	profession
cascinajo	cascinaio	profession
casellante	casellante	profession
casellanti	casellante	profession
casiera	casiere	profession
casiere	casiere	profession
casieri	casiere	profession
cassiera	cassiere	profession
cassiere	cassiere	profession
cassieri	cassiere	profession
cassierina	cassiere	profession
cassierine	cassiere	profession
cassierini	cassiere	profession
castagnai	castagnaio	profession
castagnaia	castagnaio	profession
castagnaie	castagnaio	profession
castagnaio	castagnaio	profession
castagnaj	castagnaio	profession
castagnaja	castagnaio	profession
castagnaje	castagnaio	profession
castagnaji	castagnaio	profession
castagnajo	castagnaio	profession
castalda	castaldo	profession
castalde	castaldo	profession
castaldi	castaldo	profession
castaldo	castaldo	profession
castellana	castellano	profession
castellane	castellano	profession
castellani	castellano	profession
castellano	castellano	profession
castracani	castracani	profession
castrina	castrino	profession
castrine	castrino	profession
castrini	castrino	profession
castrino	castrino	profession
catafratta	catafratto	profession
catafratte	catafratto	profession
catafratti	catafratto	profession
catafratto	catafratto	profession
catechista	catechista	ecclesiastical occupation
catechiste	catechista	ecclesiastical occupation
catechisti	catechista	ecclesiastical occupation
caterinetta	caterinetta	profession
caterinette	caterinetta	profession
caterinetti	caterinetta	profession
caterinetto	caterinetta	profession
causidica	causidico	profession
causidiche	causidico	profession
causidici	causidico	profession
causidico	causidico	profession
cavadenti	cavadenti	profession
cavaliera	cavaliere	profession
cavalierastro	cavaliere	profession
cavaliere	cavaliere	profession
cavalieri	cavaliere	profession
cavalierone	cavaliere	profession
cavalieroni	cavaliere	profession
cavalieruccio	cavaliere	profession
cavallante	cavallante	profession
cavallanti	cavallante	profession
cavallerizza	cavallerizzo	profession
cavallerizze	cavallerizzo	profession
cavallerizzi	cavallerizzo	profession
cavallerizzo	cavallerizzo	profession
cavatora	cavatore	profession
cavatore	cavatore	profession
cavatoressa	cavatore	profession
cavatoresse	cavatore	profession
cavatori	cavatore	profession
cavatrice	cavatore	profession
cavatrici	cavatore	profession
cellari	cellario	profession
cellarii	cellario	profession
cellario	cellario	profession
cellerarii	cellerario	profession
cellerario	cellerario	profession
cenciai	cenciaio	profession
cenciaia	cenciaio	profession
cenciaie	cenciaio	profession
cenciaio	cenciaio	profession
cenciaioli	cenciaiolo	profession
cenciaiolo	cenciaiolo	profession
cenciaj	cenciaio	profession
cenciaja	cenciaio	profession
cenciaje	cenciaio	profession
cenciaji	cenciaio	profession
cenciajo	cenciaio	profession
cenciajoli	cenciaiolo	profession
cenciajolo	cenciaiolo	profession
censora	censore	profession
censore	censore	profession
censoressa	censore	profession
censoresse	censore	profession
censori	censore	profession
centuriona	centurione	military rank
centurione	centurione	military rank
centurioni	centurione	military rank
cerusica	cerusico	profession
cerusiche	cerusico	profession
cerusici	cerusico	profession
cerusico	cerusico	profession
cesellatora	cesellatore	profession
cesellatore	cesellatore	profession
cesellatori	cesellatore	profession
cesellatrice	cesellatore	profession
cesellatrici	cesellatore	profession
chellerina	chellerina	profession
chellerine	chellerina	profession
chellerini	chellerina	profession
chellerino	chellerina	profession
chincagliera	chincagliere	profession
chincagliere	chincagliere	profession
chincaglieri	chincagliere	profession
chirurgi	chirurgo	profession
chirurgo	chirurgo	profession
chitarrista	chitarrista	profession
chitarriste	chitarrista	profession
chitarristi	chitarrista	profession
ciabattina	ciabattino	profession
ciabattine	ciabattino	profession
ciabattini	ciabattino	profession
ciabattino	ciabattino	profession
ciambellana	ciambellano	profession
ciambellane	ciambellano	profession
ciambellani	ciambellano	profession
ciambellano	ciambellano	profession
cicerone	cicerone	profession
ciceroni	cicerone	profession
ciclista	ciclista	profession
cicliste	ciclista	profession
ciclisti	ciclista	profession
cimatora	cimatore	profession
cimatore	cimatore	profession
cimatori	cimatore	profession
cimatrice	cimatore	profession
cimatrici	cimatore	profession
citarista	citarista	profession
citariste	citarista	profession
citaristi	citarista	profession
classicista	classicista	profession
classiciste	classicista	profession
classicisti	classicista	profession
coadiutora	coadiutore	ecclesiastical occupation
coadiutore	coadiutore	ecclesiastical occupation
coadiutoressa	coadiutore	ecclesiastical occupation
coadiutoresse	coadiutore	ecclesiastical occupation
coadiutori	coadiutore	ecclesiastical occupation
coadiutrice	coadiutore	ecclesiastical occupation
coadiutrici	coadiutore	ecclesiastical occupation
cocchiera	cocchiere	profession
cocchiere	cocchiere	profession
cocchieri	cocchiere	profession
cocomerai	cocomeraio	profession
cocomeraia	cocomeraio	profession
cocomeraie	cocomeraio	profession
cocomeraio	cocomeraio	profession
cocomeraj	cocomeraio	profession
cocomeraja	cocomeraio	profession
cocomeraje	cocomeraio	profession
cocomeraji	cocomeraio	profession
cocomerajo	cocomeraio	profession
coloni	colono	profession
colono	colono	profession
colorista	colorista	profession
coloriste	colorista	profession
coloristi	colorista	profession
coltellinai	coltellinaio	profession
coltellinaia	coltellinaio	profession
coltellinaie	coltellinaio	profession
coltellinaio	coltellinaio	profession
coltellinaj	coltellinaio	profession
coltellinaja	coltellinaio	profession
coltellinaje	coltellinaio	profession
coltellinaji	coltellinaio	profession
coltellinajo	coltellinaio	profession
coltivatora	coltivatore	profession
coltivatore	coltivatore	profession
coltivatoressa	coltivatore	profession
coltivatoresse	coltivatore	profession
coltivatori	coltivatore	profession
coltivatrice	coltivatore	profession
coltivatrici	coltivatore	profession
comandante	comandante	profession
comandanti	comandante	profession
comes	comes	noble rank
comica	comico	profession
comiche	comico	profession
comici	comico	profession
comico	comico	profession
comita	comito	military rank
comite	comito	military rank
comiti	comito	military rank
comito	comito	military rank
commediante	commediante	profession
commedianti	commediante	profession
commediografa	commediografo	profession
commediografe	commediografo	profession
commediografi	commediografo	profession
commediografo	commediografo	profession
commentatore	commentatore	profession
commentatori	commentatore	profession
commentatrice	commentatore	profession
commentatrici	commentatore	profession
commerciante	commerciante	profession
commercianti	commerciante	profession
commessa	commessa	profession
commesse	commessa	profession
commessi	commessa	profession
commessi	commesso	profession
commesso	commesso	profession
commessucce	commesso	profession
commessucci	commesso	profession
commessuccia	commesso	profession
commessuccio	commesso	profession
commissionarii	commissionario	profession
commissionario	commissionario	profession
committente	committente	profession
committenti	committente	profession
commodori	commodoro	military rank
commodoro	commodoro	military rank
compilatore	compilatore	profession
compilatori	compilatore	profession
compilatrice	compilatore	profession
compilatrici	compilatore	profession
compositora	compositore	profession
compositore	compositore	profession
compositoressa	compositore	profession
compositoresse	compositore	profession
compositori	compositore	profession
compositrice	compositore	profession
compositrici	compositore	profession
compratora	compratore	profession
compratore	compratore	profession
compratori	compratore	profession
compratrice	compratore	profession
compratrici	compratore	profession
computista	computista	profession
computiste	computista	profession
computisti	computista	profession
concertatora	concertatore	profession
concertatore	concertatore	profession
concertatori	concertatore	profession
concertatrice	concertatore	profession
concertatrici	concertatore	profession
concertista	concertista	profession
concertiste	concertista	profession
concertisti	concertista	profession
conciaioli	conciaiolo	profession
conciaiolo	conciaiolo	profession
conciajoli	conciaiolo	profession
conciajolo	conciaiolo	profession
conciapelli	conciapelli	profession
conciatora	conciatore	profession
conciatore	conciatore	profession
conciatori	conciatore	profession
conciatrice	conciatore	profession
conciatrici	conciatore	profession
concina	concino	profession
concine	concino	profession
concini	concino	profession
concino	concino	profession
conde	conde	noble rank
condi	conde	noble rank
condottiera	condottiero	profession
condottiere	condottiero	profession
condottieri	condottiero	profession
condottiero	condottiero	profession
conducente	conducente	profession
conducenti	conducente	profession
conduttora	conduttore	profession
conduttore	conduttore	profession
conduttori	conduttore	profession
conduttrice	conduttore	profession
conduttrici	conduttore	profession
conferenziera	conferenziere	profession
conferenziere	conferenziere	profession
conferenzieri	conferenziere	profession
confessora	confessore	ecclesiastical occupation
confessore	confessore	ecclesiastical occupation
confessoressa	confessore	ecclesiastical occupation
confessoresse	confessore	ecclesiastical occupation
confessori	confessore	ecclesiastical occupation
confettiera	confettiere	profession
confettiere	confettiere	profession
confettieri	confettiere	profession
connestabile	connestabile	military rank
connestabili	connestabile	military rank
conquistatora	conquistatore	profession
conquistatore	conquistatore	profession
conquistatoressa	conquistatore	profession
conquistatoresse	conquistatore	profession
conquistatori	conquistatore	profession
conquistatrice	conquistatore	profession
conquistatrici	conquistatore	profession
conservatora	conservatore	profession
conservatore	conservatore	profession
conservatori	conservatore	profession
conservatrice	conservatore	profession
conservatrici	conservatore	profession
console	console	military rank
consoli	console	military rank
consulente	consulente	profession
consulenti	consulente	profession
consultore	consultore	ecclesiastical occupation
consultori	consultore	ecclesiastical occupation
consultrice	consultore	ecclesiastical occupation
consultrici	consultore	ecclesiastical occupation
contabile	contabile	profession
contabili	contabile	profession
contadina	contadino	profession
contadine	contadino	profession
contadinella	contadino	profession
contadinelle	contadino	profession
contadinelli	contadino	profession
contadinello	contadino	profession
contadini	contadino	profession
contadino	contadino	profession
contadinucce	contadino	profession
contadinucci	contadino	profession
contadinuccia	contadino	profession
contadinuccio	contadino	profession
conte	conte	noble rank
contessa	contessa	noble rank
contesse	contessa	noble rank
conti	conte	noble rank
contini	conte	noble rank
contino	conte	noble rank
contrammiragli	contrammiraglio	military rank
contrammiraglio	contrammiraglio	military rank
controllora	controllore	profession
controllore	controllore	profession
controllori	controllore	profession
coordinatora	coordinatore	profession
coordinatore	coordinatore	profession
coordinatori	coordinatore	profession
coordinatrice	coordinatore	profession
coordinatrici	coordinatore	profession
copista	copista	profession
copiste	copista	profession
copisti	copista	profession
coppiera	coppiere	profession
coppiere	coppiere	profession
coppieri	coppiere	profession
corazziera	corazziere	military rank
corazziere	corazziere	military rank
corazzieri	corazziere	military rank
coreografa	coreografo	profession
coreografe	coreografo	profession
coreografi	coreografo	profession
coreografo	coreografo	profession
corrispondente	corrispondente	profession
corrispondenti	corrispondente	profession
corsara	corsaro	profession
corsare	corsaro	profession
corsari	corsaro	profession
corsaro	corsaro	profession
cosmografa	cosmografo	profession
cosmografe	cosmografo	profession
cosmografi	cosmografo	profession
cosmografo	cosmografo	profession
cospiratora	cospiratore	profession
cospiratore	cospiratore	profession
cospiratori	cospiratore	profession
cospiratrice	cospiratore	profession
cospiratrici	cospiratore	profession
cotoniera	cotoniere	profession
cotoniere	cotoniere	profession
cotonieri	cotoniere	profession
cozzone	cozzone	profession
cozzoni	cozzone	profession
crestai	crestaia	profession
crestaia	crestaia	profession
crestaie	crestaia	profession
crestaj	crestaia	profession
crestaja	crestaia	profession
crestaje	crestaia	profession
criminalista	criminalista	profession
criminaliste	criminalista	profession
criminalisti	criminalista	profession
crispina	crispino	profession
crispine	crispino	profession
crispini	crispino	profession
crispino	crispino	profession
crivellatora	crivellatore	profession
crivellatore	crivellatore	profession
crivellatori	crivellatore	profession
crivellatrice	crivellatore	profession
crivellatrici	crivellatore	profession
crocerossina	crocerossina	profession
crocerossine	crocerossina	profession
crocerossini	crocerossina	profession
cronachista	cronachista	profession
cronachiste	cronachista	profession
cronachisti	cronachista	profession
cronista	cronista	profession
croniste	cronista	profession
cronisti	cronista	profession
cubista	cubista	profession
cubiste	cubista	profession
cubisti	cubista	profession
cuciniera	cuciniere	profession
cuciniere	cuciniere	profession
cucinieri	cuciniere	profession
cucitora	cucitore	profession
cucitore	cucitore	profession
cucitori	cucitore	profession
cucitrice	cucitore	profession
cucitrici	cucitore	profession
cuoca	cuoco	profession
cuoche	cuoco	profession
cuochi	cuoco	profession
cuoco	cuoco	profession
cuoiai	cuoiaio	profession
cuoiaia	cuoiaio	profession
cuoiaie	cuoiaio	profession
cuoiaio	cuoiaio	profession
cuoiaj	cuoiaio	profession
cuoiaja	cuoiaio	profession
cuoiaje	cuoiaio	profession
cuoiaji	cuoiaio	profession
cuoiajo	cuoiaio	profession
cuojaj	cuoiaio	profession
cuojaja	cuoiaio	profession
cuojaje	cuoiaio	profession
cuojaji	cuoiaio	profession
cuojajo	cuoiaio	profession
curandai	curandaio	profession
curandaia	curandaio	profession
curandaie	curandaio	profession
curandaio	curandaio	profession
curandaj	curandaio	profession
curandaja	curandaio	profession
curandaje	curandaio	profession
curandaji	curandaio	profession
curandajo	curandaio	profession
curati	curato	ecclesiastical occupation
curatino	curato	ecclesiastical occupation
curato	curato	ecclesiastical occupation
curatoli	curatolo	profession
curatolo	curatolo	profession
curatora	curatore	profession
curatore	curatore	profession
curatoressa	curatore	profession
curatoresse	curato	ecclesiastical occupation
curatoresse	curatore	profession
curatori	curatore	profession
curatrice	curatore	profession
curatrici	curatore	profession
custode	custode	profession
custodi	custode	profession
dantista	dantista	profession
dantiste	dantista	profession
dantisti	dantista	profession
danzatore	danzatore	profession
danzatori	danzatore	profession
danzatrice	danzatore	profession
danzatrici	danzatore	profession
dattilografa	dattilografo	profession
dattilografe	dattilografo	profession
dattilografi	dattilografo	profession
dattilografo	dattilografo	profession
daziera	daziere	profession
daziere	daziere	profession
dazieri	daziere	profession
decani	decano	ecclesiastical occupation
decano	decano	ecclesiastical occupation
declamatore	declamatore	profession
declamatori	declamatore	profession
declamatrice	declamatore	profession
declamatrici	declamatore	profession
decoratore	decoratore	profession
decoratori	decoratore	profession
decoratrice	decoratore	profession
decoratrici	decoratore	profession
decuriona	decurione	military rank
decurione	decurione	military rank
decurioni	decurione	military rank
definitore	definitore	ecclesiastical occupation
definitori	definitore	ecclesiastical occupation
definitrice	definitore	ecclesiastical occupation
definitrici	definitore	ecclesiastical occupation
dentista	dentista	profession
dentiste	dentista	profession
dentisti	dentista	profession
deputata	deputato	profession
deputate	deputato	profession
deputati	deputato	profession
deputato	deputato	profession
despota	despota	noble rank
despote	despota	noble rank
despoti	despota	noble rank
detective	detective	profession
deviatore	deviatore	profession
deviatori	deviatore	profession
deviatrice	deviatore	profession
deviatrici	deviatore	profession
diaconessa	diaconessa	ecclesiastical occupation
diaconesse	diaconessa	ecclesiastical occupation
diaconi	diacono	ecclesiastical occupation
diacono	diacono	ecclesiastical occupation
dignitari	dignitario	noble rank
dignitario	dignitario	noble rank
dimostratore	dimostratore	profession
dimostratori	dimostratore	profession
dimostratrice	dimostratore	profession
dimostratrici	dimostratore	profession
dipendente	dipendente	profession
dipendenti	dipendente	profession
diplomatica	diplomatico	profession
diplomatiche	diplomatico	profession
diplomatici	diplomatico	profession
diplomatico	diplomatico	profession
direttora	direttore	profession
direttore	direttore	profession
direttoressa	direttore	profession
direttoresse	direttore	profession
direttori	direttore	profession
direttrice	direttore	profession
direttrici	direttore	profession
dirigente	dirigente	profession
dirigenti	dirigente	profession
disegnatore	disegnatore	profession
disegnatori	disegnatore	profession
disegnatrice	disegnatore	profession
disegnatrici	disegnatore	profession
dispensiera	dispensiere	profession
dispensiere	dispensiere	profession
dispensieri	dispensiere	profession
distillatore	distillatore	profession
distillatori	distillatore	profession
distillatrice	distillatore	profession
distillatrici	distillatore	profession
diurnista	diurnista	profession
diurniste	diurnista	profession
diurnisti	diurnista	profession
divisionari	divisionario	military rank
divisionarii	divisionario	military rank
divisionario	divisionario	military rank
docente	docente	profession
docenti	docente	profession
doganiera	doganiere	profession
doganiere	doganiere	profession
doganieri	doganiere	profession
dolciera	dolciere	profession
dolciere	dolciere	profession
dolcieri	dolciere	profession
domatora	domatore	profession
domatore	domatore	profession
domatori	domatore	profession
domatrice	domatore	profession
domatrici	domatore	profession
domenichini	domenichino	profession
domenichino	domenichino	profession
domestica	domestico	profession
domestiche	domestico	profession
domestici	domestico	profession
domestico	domestico	profession
donzelli	donzello	noble rank
donzello	donzello	noble rank
doratore	doratore	profession
doratori	doratore	profession
doratrice	doratore	profession
doratrici	doratore	profession
dragomanni	dragomanno	profession
dragomanno	dragomanno	profession
drammaturghi	drammaturgo	profession
drammaturgo	drammaturgo	profession
drappiera	drappiere	profession
drappiere	drappiere	profession
drappieri	drappiere	profession
droghiera	droghiere	profession
droghiere	droghiere	profession
droghieri	droghiere	profession
druida	druido	profession
druide	druido	profession
druidi	druido	profession
druido	druido	profession
duca	duca	noble rank
duchessa	duchessa	noble rank
duchesse	duchessa	noble rank
duchessina	duchessa	noble rank
duchessine	duchessa	noble rank
duchi	duca	noble rank
ebanista	ebanista	profession
ebaniste	ebanista	profession
ebanisti	ebanista	profession
economa	economo	profession
econome	economo	profession
economi	economo	profession
economista	economista	profession
economiste	economista	profession
economisti	economista	profession
economo	economo	profession
editore	editore	profession
editori	editore	profession
editrice	editore	profession
editrici	editore	profession
educatore	educatore	profession
educatori	educatore	profession
educatrice	educatore	profession
educatrici	educatore	profession
effendi	effendi	noble rank
egittologa	egittologo	profession
egittologhe	egittologo	profession
egittologhi	egittologo	profession
egittologi	egittologo	profession
egittologo	egittologo	profession
elemosiniera	elemosiniere	profession
elemosiniere	elemosiniere	profession
elemosinieri	elemosiniere	profession
elettrice	elettrice	noble rank
elettrici	elettrice	noble rank
elettricista	elettricista	profession
elettriciste	elettricista	profession
elettricisti	elettricista	profession
elettrotecnica	elettrotecnico	profession
elettrotecniche	elettrotecnico	profession
elettrotecnici	elettrotecnico	profession
elettrotecnico	elettrotecnico	profession
emiri	emiro	noble rank
emiro	emiro	noble rank
enciclopedista	enciclopedista	profession
enciclopediste	enciclopedista	profession
enciclopedisti	enciclopedista	profession
enologa	enologo	profession
enologhe	enologo	profession
enologhi	enologo	profession
enologi	enologo	profession
enologo	enologo	profession
entomologa	entomologo	profession
entomologhe	entomologo	profession
entomologhi	entomologo	profession
entomologi	entomologo	profession
entomologo	entomologo	profession
epigrafista	epigrafista	profession
epigrafiste	epigrafista	profession
epigrafisti	epigrafista	profession
epigrammista	epigrammista	profession
epigrammiste	epigrammista	profession
epigrammisti	epigrammista	profession
erbivendola	erbivendolo	profession
erbivendole	erbivendolo	profession
erbivendoli	erbivendolo	profession
erbivendolo	erbivendolo	profession
erborista	erborista	profession
erboriste	erborista	profession
erboristi	erborista	profession
eresiarca	eresiarca	profession
eresiarche	eresiarca	profession
eresiarchi	eresiarca	profession
esarca	esarca	ecclesiastical occupation
esarche	esarca	ecclesiastical occupation
esarchi	esarca	ecclesiastical occupation
esattora	esattore	profession
esattore	esattore	profession
esattori	esattore	profession
esattrice	esattore	profession
esattrici	esattore	profession
esegeta	esegeta	profession
esegete	esegeta	profession
esegeti	esegeta	profession
esportatora	esportatore	profession
esportatore	esportatore	profession
esportatori	esportatore	profession
esportatrice	esportatore	profession
esportatrici	esportatore	profession
esteta	esteta	profession
estete	esteta	profession
esteti	esteta	profession
etera	etera	profession
etere	etera	profession
eteri	etera	profession
etimologista	etimologista	profession
etimologiste	etimologista	profession
etimologisti	etimologista	profession
etnologa	etnologo	profession
etnologhe	etnologo	profession
etnologhi	etnologo	profession
etnologi	etnologo	profession
etnologo	etnologo	profession
fabbri	fabbro	profession
fabbro	fabbro	profession
faccendiera	faccendiere	profession
faccendiere	faccendiere	profession
faccendieri	faccendiere	profession
facchini	facchino	profession
facchino	facchino	profession
falconiera	falconiere	profession
falconiere	falconiere	profession
falconieri	falconiere	profession
falegname	falegname	profession
falegnami	falegname	profession
falsaria	falsario	profession
falsarie	falsario	profession
falsarii	falsario	profession
falsario	falsario	profession
falsari	falsario	profession
famiglii	famiglio	profession
famiglio	famiglio	profession
famigli	famiglio	profession
fanalista	fanalista	profession
fanaliste	fanalista	profession
fanalisti	fanalista	profession
fantesca	fantesca	profession
fantesche	fantesca	profession
fanteschi	fantesca	profession
fantina	fantino	profession
fantine	fantino	profession
fantini	fantino	profession
fantino	fantino	profession
faraona	faraone	noble rank
faraone	faraone	noble rank
faraoni	faraone	noble rank
farmacista	farmacista	profession
farmaciste	farmacista	profession
farmacisti	farmacista	profession
fattorina	fattorino	profession
fattorine	fattorino	profession
fattorini	fattorino	profession
fattorino	fattorino	profession
favolista	favolista	profession
favoliste	favolista	profession
favolisti	favolista	profession
feldmarescialli	feldmaresciallo	military rank
feldmaresciallo	feldmaresciallo	military rank
ferrai	ferraio	profession
feldmarescialloa	feldmaresciallo	military rank
ferraia	ferraio	profession
ferraie	ferraio	profession
ferraio	ferraio	profession
ferraiola	ferraiolo	profession
ferrajola	ferraiolo	profession
ferrajoli	ferraiolo	profession
ferrajolo	ferraiolo	profession
ferraioli	ferraiolo	profession
ferraiolo	ferraiolo	profession
ferraj	ferraio	profession
ferraja	ferraio	profession
ferraje	ferraio	profession
ferraji	ferraio	profession
ferrajo	ferraio	profession
ferravecchii	ferravecchio	profession
ferravecchio	ferravecchio	profession
ferroviera	ferroviere	profession
ferroviere	ferroviere	profession
ferrovieri	ferroviere	profession
fiaccherai	fiaccheraio	profession
fiaccheraia	fiaccheraio	profession
fiaccheraie	fiaccheraio	profession
fiaccheraio	fiaccheraio	profession
fiaccheraj	fiaccheraio	profession
fiaccheraja	fiaccheraio	profession
fiaccheraje	fiaccheraio	profession
fiaccheraji	fiaccheraio	profession
fiaccherajo	fiaccheraio	profession
fiduciaria	fiduciario	profession
fiduciarie	fiduciario	profession
fiduciarii	fiduciario	profession
fiduciario	fiduciario	profession
fiduciari	fiduciario	profession
figurinai	figurinaio	profession
figurinaia	figurinaio	profession
figurinaie	figurinaio	profession
figurinaio	figurinaio	profession
figurinaj	figurinaio	profession
figurinaja	figurinaio	profession
figurinaje	figurinaio	profession
figurinaji	figurinaio	profession
figurinajo	figurinaio	profession
figurista	figurista	profession
figuriste	figurista	profession
figuristi	figurista	profession
filandiera	filandiere	profession
filandiere	filandiere	profession
filandieri	filandiere	profession
filatore	filatore	profession
filatori	filatore	profession
filatrice	filatore	profession
filatrici	filatore	profession
filologa	filologo	profession
filologhe	filologo	profession
filologi	filologo	profession
filologhi	filologo	profession
filologo	filologo	profession
filosofa	filosofo	profession
filosofe	filosofo	profession
filosofi	filosofo	profession
filosofo	filosofo	profession
finanziera	finanziere	profession
finanziere	finanziere	profession
finanzieri	finanziere	profession
fiorai	fioraio	profession
fioraia	fioraio	profession
fioraie	fioraio	profession
fioraio	fioraio	profession
fioraj	fioraio	profession
fioraja	fioraio	profession
fioraje	fioraio	profession
fioraji	fioraio	profession
fiorajo	fioraio	profession
fiorista	fiorista	profession
fioriste	fiorista	profession
fioristi	fiorista	profession
fischiatore	fischiatore	profession
fischiatori	fischiatore	profession
fischiatrice	fischiatore	profession
fischiatrici	fischiatore	profession
fisiologa	fisiologo	profession
fisiologhe	fisiologo	profession
fisiologi	fisiologo	profession
fisiologhi	fisologo	profession
fisiologo	fisiologo	profession
fittavoli	fittavolo	profession
fittavolo	fittavolo	profession
flautista	flautista	profession
flautiste	flautista	profession
flautisti	flautista	profession
fonditore	fonditore	profession
fonditori	fonditore	profession
fonditrice	fonditore	profession
fonditrici	fonditore	profession
fontaniera	fontaniere	profession
fontaniere	fontaniere	profession
fontanieri	fontaniere	profession
foratore	foratore	profession
foratori	foratore	profession
foratrice	foratore	profession
foratrici	foratore	profession
formatore	formatore	profession
formatori	formatore	profession
formatrice	formatore	profession
formatrici	formatore	profession
fornaciai	fornaciaio	profession
fornaciaia	fornaciaio	profession
fornaciaie	fornaciaio	profession
fornaciaio	fornaciaio	profession
fornaciaj	fornaciaio	profession
fornaciaja	fornaciaio	profession
fornaciaje	fornaciaio	profession
fornaciaji	fornaciaio	profession
fornaciajo	fornaciaio	profession
fornai	fornaio	profession
fornaia	fornaio	profession
fornaie	fornaio	profession
fornaio	fornaio	profession
fornaj	fornaio	profession
fornaja	fornaio	profession
fornaje	fornaio	profession
fornaji	fornaio	profession
fornajo	fornaio	profession
fornara	fornaro	profession
fornare	fornaro	profession
fornaretta	fornaro	profession
fornarette	fornaro	profession
fornaretti	fornaro	profession
fornaretto	fornaro	profession
fornari	fornaro	profession
fornarina	fornaro	profession
fornarine	fornaro	profession
fornarini	fornaro	profession
fornaro	fornaro	profession
fossora	fossore	profession
fossore	fossore	profession
fossori	fossore	profession
fotografa	fotografo	profession
fotografe	fotografo	profession
fotografi	fotografo	profession
fotografo	fotografo	profession
frate	frate	ecclesiastical occupation
frati	frate	ecclesiastical occupation
fratino	frate	ecclesiastical occupation
fratuccio	frate	ecclesiastical occupation
fratucci	frate	ecclesiastical occupation
frenologa	frenologo	profession
frenologhe	frenologo	profession
frenologi	frenologo	profession
frenologhi	frenologo	profession
frenologo	frenologo	profession
friggitora	friggitore	profession
friggitore	friggitore	profession
friggitori	friggitore	profession
friggitrice	friggitore	profession
friggitrici	friggitore	profession
fromboliera	fromboliere	profession
fromboliere	fromboliere	profession
frombolieri	fromboliere	profession
fruttaiola	fruttaiolo	profession
fruttaiole	fruttaiolo	profession
fruttaioli	fruttaiolo	profession
fruttaiolo	fruttaiolo	profession
fruttajola	fruttaiolo	profession
fruttajole	fruttaiolo	profession
fruttajoli	fruttaiolo	profession
fruttajolo	fruttaiolo	profession
fruttivendola	fruttivendolo	profession
fruttivendole	fruttivendolo	profession
fruttivendoli	fruttivendolo	profession
fruttivendolo	fruttivendolo	profession
fuciliera	fuciliere	military rank
fuciliere	fuciliere	military rank
fucilieri	fuciliere	military rank
fulla	fullo	profession
fulle	fullo	profession
fulli	fullo	profession
fullo	fullo	profession
fumista	fumista	profession
fumiste	fumista	profession
fumisti	fumista	profession
funzionaria	funzionario	profession
funzionarie	funzionario	profession
funzionarii	funzionario	profession
funzionario	funzionario	profession
funzionari	funzionario	profession
fuochista	fuochista	profession
fuochiste	fuochista	profession
fuochisti	fuochista	profession
furiera	furiere	military rank
furiere	furiere	military rank
furieri	furiere	military rank
fusora	fusore	profession
fusore	fusore	profession
fusori	fusore	profession
gabelliera	gabelliere	profession
gabelliere	gabelliere	profession
gabellieri	gabelliere	profession
gabellini	gabellino	profession
gabellino	gabellino	profession
galoppina	galoppino	profession
galoppine	galoppino	profession
galoppini	galoppino	profession
galoppino	galoppino	profession
garzona	garzone	profession
garzone	garzone	profession
garzoni	garzone	profession
gastronomi	gastronomo	profession
gastronomo	gastronomo	profession
gastronome	gastronomo	profession
gastronom	gastronomo	profession
gaucha	gaucho	profession
gauche	gaucho	profession
gauchi	gaucho	profession
gaucho	gaucho	profession
gauchos	gaucho	profession
gelatiera	gelatiere	profession
gelatiere	gelatiere	profession
gelatieri	gelatiere	profession
gendarme	gendarme	profession
gendarmi	gendarme	profession
genealogista	genealogista	profession
genealogiste	genealogista	profession
genealogisti	genealogista	profession
generalissima	generalissimo	military rank
generalissime	generalissimo	military rank
generalissimi	generalissimo	military rank
generalissimo	generalissimo	military rank
generalessa	generale	military rank
geografa	geografo	profession
geografe	geografo	profession
geografi	geografo	profession
geografo	geografo	profession
geologa	geologo	profession
geologhe	geologo	profession
geologi	geologo	profession
geologhi	geologo	profession
geologo	geologo	profession
geometra	geometra	profession
geometre	geometra	profession
geometri	geometra	profession
gerente	gerente	profession
gerenti	gerente	profession
gerolamini	gerolamino	ecclesiastical occupation
gerolamino	gerolamino	ecclesiastical occupation
gessai	gessaio	profession
gessaia	gessaio	profession
gessaie	gessaio	profession
gessaio	gessaio	profession
gessaj	gessaio	profession
gessaja	gessaio	profession
gessaje	gessaio	profession
gessaji	gessaio	profession
gessajo	gessaio	profession
gessini	gessino	profession
gessino	gessino	profession
gestora	gestore	profession
gestore	gestore	profession
gestori	gestore	profession
gestrice	gestore	profession
gestrici	gestore	profession
gesuita	gesuita	ecclesiastical occupation
gesuite	gesuita	ecclesiastical occupation
gesuiti	gesuita	ecclesiastical occupation
ghirlandai	ghirlandaio	profession
ghirlandaia	ghirlandaio	profession
ghirlandaie	ghirlandaio	profession
ghirlandaio	ghirlandaio	profession
ghirlandaj	ghirlandaio	profession
ghirlandaja	ghirlandaio	profession
ghirlandaje	ghirlandaio	profession
ghirlandaji	ghirlandaio	profession
ghirlandajo	ghirlandaio	profession
giardiniera	giardiniere	profession
giardiniere	giardiniere	profession
giardinieri	giardiniere	profession
ginecologa	ginecologo	profession
ginecologhe	ginecologo	profession
ginecologi	ginecologo	profession
ginecologhi	ginecologo	profession
ginecologo	ginecologo	profession
ginnasta	ginnasta	profession
ginnaste	ginnasta	profession
ginnasti	ginnasta	profession
ginnetti	ginnetto	profession
ginnetto	ginnetto	profession
giocoliera	giocoliere	profession
giocoliere	giocoliere	profession
giocolieri	giocoliere	profession
gioielliera	gioielliere	profession
gioielliere	gioielliere	profession
gioiellieri	gioielliere	profession
giojelliera	gioielliere	profession
giojelliere	gioielliere	profession
giojellieri	gioielliere	profession
giornalai	giornalaio	profession
giornalaia	giornalaio	profession
giornalaie	giornalaio	profession
giornalaio	giornalaio	profession
giornalaj	giornalaio	profession
giornalaja	giornalaio	profession
giornalaje	giornalaio	profession
giornalaji	giornalaio	profession
giornalajo	giornalaio	profession
giornalista	giornalista	profession
giornaliste	giornalista	profession
giornalisti	giornalista	profession
giornante	giornante	profession
giornanti	giornante	profession
giudice	giudice	profession
giudici	giudice	profession
giullare	giullare	profession
giullari	giullare	profession
giuntatora	giuntatore	profession
giuntatore	giuntatore	profession
giuntatori	giuntatore	profession
giuntatrice	giuntatore	profession
giuntatrici	giuntatore	profession
giureconsulta	giureconsulto	profession
giureconsulti	giureconsulto	profession
giureconsulto	giureconsulto	profession
giustiziera	giustiziere	profession
giustiziere	giustiziere	profession
giustizieri	giustiziere	profession
gladiatora	gladiatore	profession
gladiatore	gladiatore	profession
gladiatori	gladiatore	profession
gladiatrice	gladiatore	profession
gladiatrici	gladiatore	profession
glossatora	glossatore	profession
glossatore	glossatore	profession
glossatori	glossatore	profession
glossatrice	glossatore	profession
glossatrici	glossatore	profession
glottologa	glottologo	profession
glottologhe	glottologo	profession
glottologi	glottologo	profession
glottologo	glottologo	profession
glottologhi	glottologo	profession
gondoliera	gondoliere	profession
gondoliere	gondoliere	profession
gondolieri	gondoliere	profession
gonfaloniera	gonfaloniere	military rank
gonfaloniere	gonfaloniere	military rank
gonfalonieri	gonfaloniere	military rank
governante	governante	profession
governanti	governante	profession
governatora	governatore	profession
governatore	governatore	profession
governatoressa	governatore	profession
governatoresse	governatore	profession
governatori	governatore	profession
governatrice	governatore	profession
governatrici	governatore	profession
grafologa	grafologo	profession
grafologhe	grafologo	profession
grafologi	grafologo	profession
grafologhi	grafologo	profession
grafologo	grafologo	profession
grammatici	grammatico	profession
grammatico	grammatico	profession
granatiera	granatiere	military rank
granatiere	granatiere	military rank
granatieri	granatiere	military rank
granduca	granduca	noble rank
granduchi	granduca	noble rank
granduchessa	granduca	noble rank
granduchesse	granduca	noble rank
grecista	grecista	profession
greciste	grecista	profession
grecisti	grecista	profession
grossista	grossista	profession
grossiste	grossista	profession
grossisti	grossista	profession
guantai	guantaio	profession
guantaia	guantaio	profession
guantaie	guantaio	profession
guantaio	guantaio	profession
guantaj	guantaio	profession
guantaja	guantaio	profession
guantaje	guantaio	profession
guantaji	guantaio	profession
guantajo	guantaio	profession
guardaboschi	guardaboschi	profession
guardacaccia	guardacaccia	profession
guardaportone	guardaportone	profession
guardaportoni	guardaportone	profession
guardarobiera	guardarobiere	profession
guardarobiere	guardarobiere	profession
guardarobieri	guardarobiere	profession
guardasala	guardasala	profession
guardasale	guardasala	profession
guardaspalle	guardaspalle	profession
guardia	guardia	profession
guardiacaccia	guardiacaccia	profession
guardiamarina	guardiamarina	military rank
guardiana	guardiano	profession
guardiane	guardiano	profession
guardiani	guardiano	profession
guardiano	guardiano	profession
guardie	guardia	profession
guaritora	guaritore	profession
guaritore	guaritore	profession
guaritori	guaritore	profession
guaritrice	guaritore	profession
guaritrici	guaritore	profession
guerriera	guerriero	profession
guerriere	guerriero	profession
guerrieri	guerriero	profession
guerriero	guerriero	profession
guida	guida	profession
guide	guida	profession
guitti	guitto	profession
guitto	guitto	profession
guittone	guitto	profession
guittoni	guitto	profession
hidalgos	hidalgo	noble rank
hidalgo	hidalgo	noble rank
hidalghi	hidalgo	noble rank
ideologa	ideologo	profession
ideologhe	ideologo	profession
ideologi	ideologo	profession
ideologo	ideologo	profession
ideologhi	ideologo	profession
idraulica	idraulico	profession
idrauliche	idraulico	profession
idraulici	idraulico	profession
idraulico	idraulico	profession
igienista	igienista	profession
igieniste	igienista	profession
igienisti	igienista	profession
illusionista	illusionista	profession
illusioniste	illusionista	profession
illusionisti	illusionista	profession
illustratora	illustratore	profession
illustratore	illustratore	profession
illustratori	illustratore	profession
illustratrice	illustratore	profession
illustratrici	illustratore	profession
imbalsamatora	imbalsamatore	profession
imbalsamatore	imbalsamatore	profession
imbalsamatori	imbalsamatore	profession
imbalsamatrice	imbalsamatore	profession
imbalsamatrici	imbalsamatore	profession
imbiancatore	imbiancatore	profession
imbiancatori	imbiancatore	profession
imbiancatrice	imbiancatore	profession
imbiancatrici	imbiancatore	profession
imbianchini	imbianchino	profession
imbianchino	imbianchino	profession
imitatora	imitatore	profession
imitatore	imitatore	profession
imitatori	imitatore	profession
imitatrice	imitatore	profession
imitatrici	imitatore	profession
imperatora	imperatore	noble rank
imperatore	imperatore	noble rank
imperatori	imperatore	noble rank
imperatrice	imperatore	noble rank
imperatrice	imperatrice	noble rank
imperatrici	imperatrice	noble rank
impiegata	impiegato	profession
impiegate	impiegato	profession
impiegati	impiegato	profession
impiegato	impiegato	profession
impiegatucce	impiegato	profession
impiegatucci	impiegato	profession
impiegatuccia	impiegato	profession
impiegatuccio	impiegato	profession
importatora	importatore	profession
importatore	importatore	profession
importatori	importatore	profession
importatrice	importatore	profession
importatrici	importatore	profession
imprenditora	imprenditore	profession
imprenditore	imprenditore	profession
imprenditori	imprenditore	profession
imprenditrice	imprenditore	profession
imprenditrici	imprenditore	profession
impresaria	impresario	profession
impresarie	impresario	profession
impresarii	impresario	profession
impresari	impresario	profession
impresario	impresario	profession
improvvisatora	improvvisatore	profession
improvvisatore	improvvisatore	profession
improvvisatori	improvvisatore	profession
improvvisatrice	improvvisatore	profession
improvvisatrici	improvvisatore	profession
incisora	incisore	profession
incisore	incisore	profession
incisori	incisore	profession
industriale	industriale	profession
industriali	industriale	profession
infermiera	infermiere	profession
infermiere	infermiere	profession
infermieri	infermiere	profession
infermierina	infermiere	profession
infermierine	infermiere	profession
infermierini	infermiere	profession
ingaggiatora	ingaggiatore	profession
ingaggiatore	ingaggiatore	profession
ingaggiatori	ingaggiatore	profession
ingaggiatrice	ingaggiatore	profession
ingaggiatrici	ingaggiatore	profession
ingegnera	ingegnere	profession
ingegnere	ingegnere	profession
ingegneri	ingegnere	profession
ingegnerina	ingegnere	profession
ingegnerine	ingegnere	profession
ingegnerini	ingegnere	profession
ingegnerino	ingegnere	profession
inquisitora	inquisitore	ecclesiastical occupation
inquisitore	inquisitore	ecclesiastical occupation
inquisitori	inquisitore	ecclesiastical occupation
inquisitrice	inquisitore	ecclesiastical occupation
inquisitrici	inquisitore	ecclesiastical occupation
insegnante	insegnante	profession
insegnanti	insegnante	profession
inserviente	inserviente	profession
inservienti	inserviente	profession
intagliatora	intagliatore	profession
intagliatore	intagliatore	profession
intagliatori	intagliatore	profession
intagliatrice	intagliatore	profession
intagliatrici	intagliatore	profession
intellettuale	intellettuale	profession
intellettuali	intellettuale	profession
intermediaria	intermediario	profession
intermediarie	intermediario	profession
intermediarii	intermediario	profession
intermediario	intermediario	profession
intermediario	intermediario	profession
interprete	interprete	profession
interpreti	interprete	profession
intervistatora	intervistatore	profession
intervistatore	intervistatore	profession
intervistatori	intervistatore	profession
intervistatrice	intervistatore	profession
intervistatrici	intervistatore	profession
inventora	inventore	profession
inventore	inventore	profession
inventori	inventore	profession
inventrice	inventore	profession
inventrici	inventore	profession
investigatora	investigatore	profession
investigatore	investigatore	profession
investigatori	investigatore	profession
investigatrice	investigatore	profession
investigatrici	investigatore	profession
ispettora	ispettore	profession
ispettore	ispettore	profession
ispettori	ispettore	profession
ispettrice	ispettore	profession
ispettrici	ispettore	profession
istitutrice	istitutrice	profession
istitutrici	istitutrice	profession
istruttora	istruttore	profession
istruttore	istruttore	profession
istruttori	istruttore	profession
istruttrice	istruttore	profession
istruttrici	istruttore	profession
lampionai	lampionaio	profession
lampionaia	lampionaio	profession
lampionaie	lampionaio	profession
lampionaio	lampionaio	profession
lampionaj	lampionaio	profession
lampionaja	lampionaio	profession
lampionaje	lampionaio	profession
lampionaji	lampionaio	profession
lampionajo	lampionaio	profession
lanaioli	lanaiolo	profession
lanaiolo	lanaiolo	profession
lanajoli	lanaiolo	profession
lanajolo	lanaiolo	profession
lanaiola	lanaiolo	profession
lanaiole	lanaiolo	profession
lanajola	lanaiolo	profession
lanajole	lanaiolo	profession
langravii	langravio	noble rank
langravio	langravio	noble rank
langravi	langravio	noble rank
laniera	laniere	profession
laniere	laniere	profession
lanieri	laniere	profession
latinista	latinista	profession
latiniste	latinista	profession
latinisti	latinista	profession
lattai	lattaio	profession
lattaia	lattaio	profession
lattaie	lattaio	profession
lattaio	lattaio	profession
lattaj	lattaio	profession
lattaja	lattaio	profession
lattaje	lattaio	profession
lattaji	lattaio	profession
lattajo	lattaio	profession
lattari	lattaro	profession
lattaro	lattaro	profession
lattivendoli	lattivendolo	profession
lattivendolo	lattivendolo	profession
lavandai	lavandaio	profession
lavandaia	lavandaio	profession
lavandaie	lavandaio	profession
lavandaio	lavandaio	profession
lavandaj	lavandaio	profession
lavandaja	lavandaio	profession
lavandaje	lavandaio	profession
lavandaji	lavandaio	profession
lavandajo	lavandaio	profession
lavapiatti	lavapiatti	profession
lavatora	lavatore	profession
lavatore	lavatore	profession
lavatori	lavatore	profession
lavatrice	lavatore	profession
lavatrici	lavatore	profession
lavorante	lavorante	profession
lavoranti	lavorante	profession
legatora	legatore	profession
legatore	legatore	profession
legatori	legatore	profession
legatrice	legatore	profession
legatrici	legatore	profession
legnaiola	legnaiolo	profession
legnaiole	legnaiolo	profession
legnaioli	legnaiolo	profession
legnaiolo	legnaiolo	profession
legnajola	legnaiolo	profession
legnajole	legnaiolo	profession
legnajoli	legnaiolo	profession
legnajolo	legnaiolo	profession
letterata	letterato	profession
letterate	letterato	profession
letterati	letterato	profession
letterato	letterato	profession
lettighiera	lettighiere	profession
lettighiere	lettighiere	profession
lettighieri	lettighiere	profession
lettora	lettore	profession
lettore	lettore	profession
lettori	lettore	profession
lettrice	lettore	profession
lettrici	lettore	profession
levatrice	levatrice	profession
levatrici	levatrice	profession
librai	libraio	profession
libraia	libraio	profession
libraie	libraio	profession
libraio	libraio	profession
libraj	libraio	profession
libraja	libraio	profession
libraje	libraio	profession
libraji	libraio	profession
librajo	libraio	profession
librettista	librettista	profession
librettiste	librettista	profession
librettisti	librettista	profession
linguista	linguista	profession
linguiste	linguista	profession
linguisti	linguista	profession
litografa	litografo	profession
litografe	litografo	profession
litografi	litografo	profession
litografo	litografo	profession
littora	littore	profession
littore	littore	profession
littori	littore	profession
littrice	littore	profession
littrici	littore	profession
liutista	liutista	profession
liutiste	liutista	profession
liutisti	liutista	profession
livellatora	livellatore	profession
livellatore	livellatore	profession
livellatori	livellatore	profession
livellatrice	livellatore	profession
livellatrici	livellatore	profession
locandiera	locandiere	profession
locandiere	locandiere	profession
locandieri	locandiere	profession
logoteta	logoteta	profession
logotete	logoteta	profession
logoteti	logoteta	profession
lucumone	lucumone	noble rank
lucumoni	lucumone	noble rank
lumai	lumaio	profession
lumaia	lumaio	profession
lumaie	lumaio	profession
lumaio	lumaio	profession
lumaj	lumaio	profession
lumaja	lumaio	profession
lumaje	lumaio	profession
lumaji	lumaio	profession
lumajo	lumaio	profession
luogotenente	luogotenente	military rank
luogotenenti	luogotenente	military rank
lustrascarpe	lustrascarpe	profession
macchinista	macchinista	profession
macchiniste	macchinista	profession
macchinisti	macchinista	profession
macellai	macellaio	profession
macellaia	macellaio	profession
macellaie	macellaio	profession
macellaio	macellaio	profession
macellaj	macellaio	profession
macellaja	macellaio	profession
macellaje	macellaio	profession
macellaji	macellaio	profession
macellajo	macellaio	profession
macellatora	macellatore	profession
macellatore	macellatore	profession
macellatori	macellatore	profession
macellatrice	macellatore	profession
macellatrici	macellatore	profession
maestra	maestro	military rank
maestre	maestro	military rank
maestri	maestro	military rank
maestrina	maestro	military rank
maestrine	maestro	military rank
maestrini	maestro	military rank
maestrino	maestro	military rank
maestro	maestro	military rank
maestrucce	maestro	military rank
maestrucci	maestro	military rank
maestruccia	maestro	military rank
maestruccio	maestro	military rank
magazziniera	magazziniere	profession
magazziniere	magazziniere	profession
magazzinieri	magazziniere	profession
maggiora	maggiore	military rank
maggiordoma	maggiordomo	profession
maggiordome	maggiordomo	profession
maggiordomi	maggiordomo	profession
maggiordomo	maggiordomo	profession
maggioressa	maggiore	military rank
maggioresse	maggiore	military rank
magistrata	magistrato	profession
magistrati	magistrato	profession
magistrato	magistrato	profession
magnana	magnano	profession
magnane	magnano	profession
magnani	magnano	profession
magnano	magnano	profession
magnate	magnate	profession
magnati	magnate	profession
maliscalche	maliscalco	profession
maliscalca	maliscalco	profession
maliscalchi	maliscalco	profession
maliscalco	maliscalco	profession
mammana	mammana	profession
mammane	mammana	profession
mammani	mammana	profession
mandolinista	mandolinista	profession
mandoliniste	mandolinista	profession
mandolinisti	mandolinista	profession
mandriana	mandriano	profession
mandriane	mandriano	profession
mandriani	mandriano	profession
mandriano	mandriano	profession
manifatturiera	manifatturiere	profession
manifatturiere	manifatturiere	profession
manifatturieri	manifatturiere	profession
maniscalchi	maniscalco	profession
maniscalco	maniscalco	profession
maniscalche	maniscalco	profession
maniscalca	maniscalco	profession
manovale	manovale	profession
manovali	manovale	profession
manovratora	manovratore	profession
manovratore	manovratore	profession
manovratori	manovratore	profession
manovratrice	manovratore	profession
manovratrici	manovratore	profession
mansionari	mansionario	profession
mansionarii	mansionario	profession
mansionario	mansionario	profession
marangona	marangone	profession
marangone	marangone	profession
marangoni	marangone	profession
marchese	marchese	noble rank
marchesi	marchese	noble rank
marchesina	marchese	noble rank
marchesine	marchese	noble rank
marchesini	marchese	noble rank
marchesino	marchese	noble rank
marescalchi	marescalco	profession
marescalco	marescalco	profession
marescalche	marescalco	profession
marescalca	marescalco	profession
marescialla	maresciallo	profession
marescialle	maresciallo	profession
marescialli	maresciallo	profession
maresciallo	maresciallo	profession
margari	margaro	profession
margaro	margaro	profession
margravii	margravio	noble rank
margravio	margravio	noble rank
margravi	margravio	noble rank
marinai	marinaio	profession
marinaia	marinaio	profession
marinaie	marinaio	profession
marinaio	marinaio	profession
marinari	marinaro	profession
marinara	marinaro	profession
marinare	marinaro	profession
marinaro	marinaro	profession
marinaretti	marinaro	profession
marinaretta	marinaro	profession
marinarette	marinaro	profession
marinaretto	marinaro	profession
marinaj	marinaio	profession
marinaja	marinaio	profession
marinaje	marinaio	profession
marinaji	marinaio	profession
marinajo	marinaio	profession
marionettista	marionettista	profession
marionettiste	marionettista	profession
marionettisti	marionettista	profession
marmista	marmista	profession
marmiste	marmista	profession
marmisti	marmista	profession
massai	massaio	profession
massaia	massaio	profession
massaie	massaio	profession
massaio	massaio	profession
massaj	massaio	profession
massaja	massaio	profession
massaje	massaio	profession
massaji	massaio	profession
massajo	massaio	profession
massara	massaro	profession
massare	massaro	profession
massari	massaro	profession
massaro	massaro	profession
materassai	materassaio	profession
materassaia	materassaio	profession
materassaie	materassaio	profession
materassaio	materassaio	profession
materassaj	materassaio	profession
materassaja	materassaio	profession
materassaje	materassaio	profession
materassaji	materassaio	profession
materassajo	materassaio	profession
mattatora	mattatore	profession
mattatore	mattatore	profession
mattatori	mattatore	profession
mattatrice	mattatore	profession
mattatrici	mattatore	profession
mattonai	mattonaio	profession
mattonaia	mattonaio	profession
mattonaie	mattonaio	profession
mattonaio	mattonaio	profession
mattonaj	mattonaio	profession
mattonaja	mattonaio	profession
mattonaje	mattonaio	profession
mattonaji	mattonaio	profession
mattonajo	mattonaio	profession
mazziera	mazziere	military rank
mazziere	mazziere	military rank
mazzieri	mazziere	military rank
mediatora	mediatore	profession
mediatore	mediatore	profession
mediatori	mediatore	profession
mediatrice	mediatore	profession
mediatrici	mediatore	profession
medica	medico	profession
medichessa	medico	profession
mediche	medico	profession
medici	medico	profession
medico	medico	profession
medicona	medico	profession
medicone	medico	profession
mediconi	medico	profession
menestrelli	menestrello	profession
menestrella	menestrello	profession
menestrello	menestrello	profession
mercante	mercante	profession
mercantessa	mercantessa	profession
mercantesse	mercantessa	profession
mercanti	mercante	profession
mercenaria	mercenario	profession
mercenarie	mercenario	profession
mercenarii	mercenario	profession
mercenari	mercenario	profession
mercenario	mercenario	profession
merciai	merciaio	profession
merciaia	merciaio	profession
merciaie	merciaio	profession
merciaio	merciaio	profession
merciaj	merciaio	profession
merciaja	merciaio	profession
merciaje	merciaio	profession
merciaji	merciaio	profession
merciajo	merciaio	profession
meretrice	meretrice	profession
meretrici	meretrice	profession
merlettaia	merlettaia	profession
merlettaie	merlettaia	profession
merlettaii	merlettaia	profession
merlettaio	merlettaia	profession
merlettaj	merlettaia	profession
merlettaja	merlettaia	profession
merlettaje	merlettaia	profession
merlettaji	merlettaia	profession
merlettajo	merlettaia	profession
messaggera	messaggero	profession
messaggere	messaggero	profession
messaggeri	messaggero	profession
messaggero	messaggero	profession
meteorologa	meteorologo	profession
meteorologhe	meteorologo	profession
meteorologi	meteorologo	profession
meteorologhi	meteorologo	profession
meteorologo	meteorologo	profession
metropolita	metropolita	ecclesiastical occupation
metropolite	metropolita	ecclesiastical occupation
metropoliti	metropolita	ecclesiastical occupation
mezzadra	mezzadro	profession
mezzadre	mezzadro	profession
mezzadri	mezzadro	profession
mezzadro	mezzadro	profession
mietitora	mietitore	profession
mietitore	mietitore	profession
mietitori	mietitore	profession
mietitrice	mietitore	profession
mietitrici	mietitore	profession
militare	militare	profession
militari	militare	profession
minatora	minatore	profession
minatore	minatore	profession
minatori	minatore	profession
minatrice	minatore	profession
minatrici	minatore	profession
miniatora	miniatore	profession
miniatore	miniatore	profession
miniatori	miniatore	profession
miniatrice	miniatore	profession
miniatrici	miniatore	profession
ministra	ministra	profession
ministre	ministra	profession
ministri	ministra	profession
ministro	ministra	profession
mirmillona	mirmillone	profession
mirmillone	mirmillone	profession
mirmilloni	mirmillone	profession
missionaria	missionario	profession
missionarie	missionario	profession
missionarii	missionario	profession
missionario	missionario	profession
missionari	missionario	profession
mobiliera	mobiliere	profession
mobiliere	mobiliere	profession
mobilieri	mobiliere	profession
modella	modello	profession
		
modellatore	modellatore	profession
modellatori	modellatore	profession
modellatrice	modellatore	profession
modellatrici	modellatore	profession
modelle	modello	profession
modista	modista	profession
modiste	modista	profession
modisti	modista	profession
molinara	molinaro	profession
molinare	molinaro	profession
molinari	molinaro	profession
molinaro	molinaro	profession
monaca	monaca	ecclesiastical occupation
monache	monaca	ecclesiastical occupation
monaci	monaca	ecclesiastical occupation
monaco	monaca	ecclesiastical occupation
monachina	monaca	ecclesiastical occupation
monachine	monaca	ecclesiastical occupation
monachini	monaca	ecclesiastical occupation
monachino	monaca	ecclesiastical occupation
monacucce	monaca	ecclesiastical occupation
monacucci	monaca	ecclesiastical occupation
monacuccia	monaca	ecclesiastical occupation
monacuccio	monaca	ecclesiastical occupation
monarca	monarca	noble rank
monarche	monarca	noble rank
monarchi	monarca	noble rank
mondina	mondina	profession
mondine	mondina	profession
mondini	mondina	profession
mondino	mondina	profession
monsignora	monsignore	noble rank
monsignore	monsignore	noble rank
monsignori	monsignore	noble rank
montatora	montatore	profession
montatore	montatore	profession
montatori	montatore	profession
montatrice	montatore	profession
montatrici	montatore	profession
moralista	moralista	profession
moraliste	moralista	profession
moralisti	moralista	profession
mosaicista	mosaicista	profession
mosaiciste	mosaicista	profession
mosaicisti	mosaicista	profession
moschettiera	moschettiere	profession
moschettiere	moschettiere	profession
moschettieri	moschettiere	profession
motorista	motorista	profession
motoriste	motorista	profession
motoristi	motorista	profession
mozzi	mozzo	profession
mozzo	mozzo	profession
mugnai	mugnaio	profession
mugnaia	mugnaio	profession
mugnaie	mugnaio	profession
mugnaio	mugnaio	profession
mugnaj	mugnaio	profession
mugnaja	mugnaio	profession
mugnaje	mugnaio	profession
mugnaji	mugnaio	profession
mugnajo	mugnaio	profession
mulattiera	mulattiere	profession
mulattiere	mulattiere	profession
mulattieri	mulattiere	profession
mulinara	mulinaro	profession
mulinare	mulinaro	profession
mulinari	mulinaro	profession
mulinaro	mulinaro	profession
muratora	muratore	profession
muratore	muratore	profession
muratori	muratore	profession
muratorini	muratore	profession
muratorino	muratore	profession
muratrice	muratore	profession
muratrici	muratore	profession
musicante	musicante	profession
musicanti	musicante	profession
musicista	musicista	profession
musiciste	musicista	profession
musicisti	musicista	profession
narratora	narratore	profession
narratore	narratore	profession
narratori	narratore	profession
narratrice	narratore	profession
narratrici	narratore	profession
naturalista	naturalista	profession
naturaliste	naturalista	profession
naturalisti	naturalista	profession
navigatora	navigatore	profession
navigatore	navigatore	profession
navigatori	navigatore	profession
navigatrice	navigatore	profession
navigatrici	navigatore	profession
necrofora	necroforo	profession
necrofore	necroforo	profession
necrofori	necroforo	profession
necroforo	necroforo	profession
negoziante	negoziante	profession
negozianti	negoziante	profession
negus	negus	noble rank
netturbini	netturbino	profession
netturbino	netturbino	profession
netturbina	netturbino	profession
netturbine	netturbino	profession
neurologa	neurologo	profession
neurologhe	neurologo	profession
neurologi	neurologo	profession
neurologhi	neurologo	profession
neurologo	neurologo	profession
nocchiera	nocchiero	profession
nocchieri	nocchiero	profession
nocchiero	nocchiero	profession
norcina	norcino	profession
norcini	norcino	profession
norcino	norcino	profession
nostromi	nostromo	military rank
nostromo	nostromo	military rank
nostrome	nostromo	military rank
nostroma	nostromo	military rank
notai	notaio	profession
notaia	notaio	profession
notaie	notaio	profession
notaio	notaio	profession
notaj	notaio	profession
notaja	notaio	profession
notaje	notaio	profession
notaji	notaio	profession
notajo	notaio	profession
numismatici	numismatico	profession
numismatico	numismatico	profession
nutrice	nutrice	profession
nutrici	nutrice	profession
oblati	oblati	profession
oculista	oculista	profession
oculiste	oculista	profession
oculisti	oculista	profession
ombrellai	ombrellaio	profession
ombrellaia	ombrellaio	profession
ombrellaie	ombrellaio	profession
ombrellaio	ombrellaio	profession
ombrellaj	ombrellaio	profession
ombrellaja	ombrellaio	profession
ombrellaje	ombrellaio	profession
ombrellaji	ombrellaio	profession
ombrellajo	ombrellaio	profession
operai	operaio	profession
operaia	operaio	profession
operaie	operaio	profession
operaio	operaio	profession
operaj	operaio	profession
operaja	operaio	profession
operaje	operaio	profession
operaji	operaio	profession
operajo	operaio	profession
operatora	operatore	profession
operatore	operatore	profession
operatori	operatore	profession
operatrice	operatore	profession
operatrici	operatore	profession
orafi	orafo	profession
orafo	orafo	profession
oratora	oratore	profession
oratore	oratore	profession
oratori	oratore	profession
oratrice	oratore	profession
oratrici	oratore	profession
orditora	orditore	profession
orditore	orditore	profession
orditori	orditore	profession
orditrice	orditore	profession
orditrici	orditore	profession
orefice	orefice	profession
orefici	orefice	profession
organara	organaro	profession
organare	organaro	profession
organari	organaro	profession
organaro	organaro	profession
organizzatora	organizzatore	profession
organizzatore	organizzatore	profession
organizzatori	organizzatore	profession
organizzatrice	organizzatore	profession
organizzatrici	organizzatore	profession
orientalista	orientalista	profession
orientaliste	orientalista	profession
orientalisti	orientalista	profession
ornatista	ornatista	profession
ornatiste	ornatista	profession
ornatisti	ornatista	profession
ornitologa	ornitologo	profession
ornitologhe	ornitologo	profession
ornitologi	ornitologo	profession
ornitologo	ornitologo	profession
orologiai	orologiaio	profession
orologiaia	orologiaio	profession
orologiaie	orologiaio	profession
orologiaio	orologiaio	profession
orologiaj	orologiaio	profession
orologiaja	orologiaio	profession
orologiaje	orologiaio	profession
orologiaji	orologiaio	profession
orologiajo	orologiaio	profession
orticoltora	orticoltore	profession
orticoltore	orticoltore	profession
orticoltori	orticoltore	profession
orticoltrice	orticoltore	profession
orticoltrici	orticoltore	profession
orticultora	orticultore	profession
orticultore	orticultore	profession
orticultori	orticultore	profession
orticultrice	orticultore	profession
orticultrici	orticultore	profession
ortolana	ortolano	profession
ortolane	ortolano	profession
ortolani	ortolano	profession
ortolano	ortolano	profession
ortopedica	ortopedico	profession
ortopediche	ortopedico	profession
ortopedici	ortopedico	profession
ortopedico	ortopedico	profession
oste	oste	profession
ostessa	oste	profession
osti	oste	profession
ostesse	oste	profession
ostetrica	ostetrico	profession
ostetriche	ostetrico	profession
ostetrici	ostetrico	profession
ostetrico	ostetrico	profession
paggii	paggio	noble rank
paggio	paggio	noble rank
paggi	paggio	noble rank
paggetto	paggio	noble rank
paggetti	paggio	noble rank
palafrenieri	palafreniero	profession
palafreniero	palafreniero	profession
palafreniere	palafreniero	profession
palombara	palombaro	profession
palombare	palombaro	profession
palombari	palombaro	profession
palombaro	palombaro	profession
panegirista	panegirista	profession
panegiriste	panegirista	profession
panegiristi	panegirista	profession
panettiera	panettiere	profession
panettiere	panettiere	profession
panettieri	panettiere	profession
papa	papa	ecclesiastical occupation
papi	papa	ecclesiastical occupation
parroci	parroco	ecclesiastical occupation
parroco	parroco	ecclesiastical occupation
parrocuccio	parroco	ecclesiastical occupation
parrocucci	parroco	ecclesiastical occupation
parrucchiera	parrucchiere	profession
parrucchiere	parrucchiere	profession
parrucchieri	parrucchiere	profession
pastai	pastaio	profession
pastaia	pastaio	profession
pastaie	pastaio	profession
pastaio	pastaio	profession
pastaj	pastaio	profession
pastaja	pastaio	profession
pastaje	pastaio	profession
pastaji	pastaio	profession
pastajo	pastaio	profession
pasticcere	pasticcere	profession
pasticceri	pasticcere	profession
pasticciera	pasticciere	profession
pasticciere	pasticciere	profession
pasticcieri	pasticciere	profession
pastora	pastore	profession
pastore	pastore	profession
pastoressa	pastore	profession
pastoresse	pastore	profession
pastori	pastore	profession
pastorina	pastore	profession
pastorine	pastore	profession
pastorini	pastore	profession
pastorino	pastore	profession
patologa	patologo	profession
patologhe	patologo	profession
patologi	patologo	profession
patologhi	patologo	profession
patologo	patologo	profession
patriarca	patriarca	ecclesiastical occupation
patriarche	patriarca	ecclesiastical occupation
patriarchi	patriarca	ecclesiastical occupation
pecorai	pecoraio	profession
pecoraia	pecoraio	profession
pecoraie	pecoraio	profession
pecoraio	pecoraio	profession
pecoraj	pecoraio	profession
pecoraja	pecoraio	profession
pecoraje	pecoraio	profession
pecoraji	pecoraio	profession
pecorajo	pecoraio	profession
pecorari	pecoraro	profession
pecoraro	pecoraro	profession
pedagogista	pedagogista	profession
pedagogiste	pedagogista	profession
pedagogisti	pedagogista	profession
pellettiera	pellettiere	profession
pellettiere	pellettiere	profession
pellettieri	pellettiere	profession
pellicciai	pellicciaio	profession
pellicciaia	pellicciaio	profession
pellicciaie	pellicciaio	profession
pellicciaio	pellicciaio	profession
pellicciaj	pellicciaio	profession
pellicciaja	pellicciaio	profession
pellicciaje	pellicciaio	profession
pellicciaji	pellicciaio	profession
pellicciajo	pellicciaio	profession
penitenziera	penitenziere	ecclesiastical occupation
penitenziere	penitenziere	ecclesiastical occupation
penitenzieri	penitenziere	ecclesiastical occupation
pentolai	pentolaio	profession
pentolaia	pentolaio	profession
pentolaie	pentolaio	profession
pentolaio	pentolaio	profession
pentolaj	pentolaio	profession
pentolaja	pentolaio	profession
pentolaje	pentolaio	profession
pentolaji	pentolaio	profession
pentolajo	pentolaio	profession
perite	perito	profession
periti	perito	profession
perito	perito	profession
		
perpetue	perpetua	profession
perpetui	perpetua	profession
pescatora	pescatore	profession
pescatore	pescatore	profession
pescatoressa	pescatore	profession
pescatoresse	pescatore	profession
pescatori	pescatore	profession
pescatorucce	pescatore	profession
pescatorucci	pescatore	profession
pescatoruccia	pescatore	profession
pescatoruccio	pescatore	profession
pescatrice	pescatore	profession
pescatrici	pescatore	profession
pesciaioli	pesciaiolo	profession
pesciaiolo	pesciaiolo	profession
pesciajoli	pesciaiolo	profession
pesciajolo	pesciaiolo	profession
pesciaiola	pesciaiolo	profession
pesciaiole	pesciaiolo	profession
pesciajola	pesciaiolo	profession
pesciajole	pesciaiolo	profession
pescivendola	pescivendolo	profession
pescivendole	pescivendolo	profession
pescivendoli	pescivendolo	profession
pescivendolo	pescivendolo	profession
petroliera	petroliere	profession
petroliere	petroliere	profession
petrolieri	petroliere	profession
pettinatrice	pettinatrice	profession
pettinatrici	pettinatrice	profession
piantatora	piantatore	profession
piantatore	piantatore	profession
piantatori	piantatore	profession
piantatrice	piantatore	profession
piantatrici	piantatore	profession
picconiera	picconiere	profession
picconiere	picconiere	profession
picconieri	picconiere	profession
pievani	pievano	ecclesiastical occupation
pievano	pievano	ecclesiastical occupation
pifferari	pifferaro	profession
pifferaro	pifferaro	profession
pifferara	pifferaro	profession
pifferare	pifferaro	profession
pilota	piloto	profession
piloti	piloto	profession
pilote	piloto	profession
piloto	piloto	profession
pioniera	pioniere	profession
pioniere	pioniere	profession
pionieri	pioniere	profession
pittora	pittore	profession
pittore	pittore	profession
pittori	pittore	profession
pittorucce	pittore	profession
pittorucci	pittore	profession
pittoruccia	pittore	profession
pittoruccio	pittore	profession
pittorastro	pittore	profession
pittorastra	pittore	profession
pittorastri	pittore	profession
pittoruccio	pittore	profession
pittrice	pittore	profession
pittrici	pittore	profession
pizia	pizia	profession
pizie	pizia	profession
pizii	pizia	profession
pizzardone	pizzardone	profession
pizzardoni	pizzardone	profession
pizzicagnola	pizzicagnolo	profession
pizzicagnole	pizzicagnolo	profession
pizzicagnoli	pizzicagnolo	profession
pizzicagnolo	pizzicagnolo	profession
poeta	poeta	profession
poete	poeta	profession
poetessa	poetessa	profession
poetesse	poetessa	profession
poeti	poeta	profession
poetina	poetessa	profession
poetine	poetessa	profession
poetini	poeta	profession
poetino	poeta	profession
poetuccio	poeta	profession
poetuccia	poetessa	profession
poetastra	poetessa	profession
poetastre	poetessa	profession
poetastro	poeta	profession
poetastri	poeta	profession
politici	politico	profession
politico	politico	profession
poliziotti	poliziotto	profession
poliziotta	poliziotto	profession
poliziotte	poliziotto	profession
poliziotto	poliziotto	profession
pollajola	pollaiolo	profession
pollajole	pollaiolo	profession
pollajoli	pollaiolo	profession
pollajolo	pollaiolo	profession
pollajuola	pollaiuolo	profession
pollajuole	pollaiuolo	profession
pollajuoli	pollaiuolo	profession
pollajuolo	pollaiuolo	profession
pollaiola	pollaiolo	profession
pollaiole	pollaiolo	profession
pollaioli	pollaiolo	profession
pollaiolo	pollaiolo	profession
pollaiuola	pollaiuolo	profession
pollaiuole	pollaiuolo	profession
pollaiuoli	pollaiuolo	profession
pollaiuolo	pollaiuolo	profession
pollivendola	pollivendolo	profession
pollivendole	pollivendolo	profession
pollivendoli	pollivendolo	profession
pollivendolo	pollivendolo	profession
pompiera	pompiere	profession
pompiere	pompiere	profession
pompieri	pompiere	profession
porcai	porcaio	profession
porcaia	porcaio	profession
porcaie	porcaio	profession
porcaio	porcaio	profession
porcaj	porcaio	profession
porcaja	porcaio	profession
porcaje	porcaio	profession
porcaji	porcaio	profession
porcajo	porcaio	profession
porcara	porcaro	profession
porcare	porcaro	profession
porcari	porcaro	profession
porcaro	porcaro	profession
portabagagli	portabagagli	profession
portabandiera	portabandiera	profession
portalettere	portalettere	profession
portantini	portantino	profession
portantino	portantino	profession
portatora	portatore	profession
portatore	portatore	profession
portatori	portatore	profession
portatrice	portatore	profession
portatrici	portatore	profession
portavoce	portavoce	profession
portiera	portiere	profession
portiere	portiere	profession
portieri	portiere	profession
portinai	portinaio	profession
portinaia	portinaio	profession
portinaie	portinaio	profession
portinaio	portinaio	profession
portinaj	portinaio	profession
portinaja	portinaio	profession
portinaje	portinaio	profession
portinaji	portinaio	profession
portinajo	portinaio	profession
portuale	portuale	profession
portuali	portuale	profession
postiglione	postiglione	profession
postiglioni	postiglione	profession
postina	postino	profession
postine	postino	profession
postini	postino	profession
postino	postino	profession
potatora	potatore	profession
potatore	potatore	profession
potatori	potatore	profession
potatrice	potatore	profession
potatrici	potatore	profession
praticone	praticone	profession
praticoni	praticone	profession
predicatora	predicatore	profession
predicatore	predicatore	profession
predicatoressa	predicatore	profession
predicatoresse	predicatore	profession
predicatori	predicatore	profession
predicatrice	predicatore	profession
predicatrici	predicatore	profession
prefetta	prefetto	military rank
prefette	prefetto	military rank
prefetti	prefetto	military rank
prefetto	prefetto	military rank
prefica	prefica	profession
prefiche	prefica	profession
prefichi	prefica	profession
prefico	prefica	profession
prelati	prelato	ecclesiastical occupation
prelatino	prelato	ecclesiastical occupation
prelatini	prelato	ecclesiastical occupation
prelatucci	prelato	ecclesiastical occupation
prelatuccio	prelato	ecclesiastical occupation
prelato	prelato	ecclesiastical occupation
presbiteri	presbitero	ecclesiastical occupation
presbitero	presbitero	ecclesiastical occupation
presentatora	presentatore	profession
presentatore	presentatore	profession
presentatori	presentatore	profession
presentatrice	presentatore	profession
presentatrici	presentatore	profession
prestidigitatora	prestidigitatore	profession
prestidigitatore	prestidigitatore	profession
prestidigitatori	prestidigitatore	profession
prestidigitatrice	prestidigitatore	profession
prestidigitatrici	prestidigitatore	profession
prestigiatora	prestigiatore	profession
prestigiatore	prestigiatore	profession
prestigiatori	prestigiatore	profession
prestigiatrice	prestigiatore	profession
prestigiatrici	prestigiatore	profession
prestinai	prestinaio	profession
prestinaia	prestinaio	profession
prestinaie	prestinaio	profession
prestinaio	prestinaio	profession
prestinaj	prestinaio	profession
prestinaja	prestinaio	profession
prestinaje	prestinaio	profession
prestinaji	prestinaio	profession
prestinajo	prestinaio	profession
pretora	pretore	profession
pretore	pretore	profession
pretoressa	pretore	profession
pretoresse	pretore	profession
pretori	pretore	profession
pretrice	pretore	profession
pretrici	pretore	profession
prevosti	prevosto	ecclesiastical occupation
prevostini	prevosto	ecclesiastical occupation
prevostino	prevosto	ecclesiastical occupation
prevosto	prevosto	ecclesiastical occupation
priore	priore	ecclesiastical occupation
priori	priore	ecclesiastical occupation
priora	priore	ecclesiastical occupation
primicerii	primicerio	profession
primiceri	primicerio	profession
primicerio	primicerio	profession
principe	principe	noble rank
principessa	principessa	noble rank
principesse	principessa	noble rank
principi	principe	noble rank
principina	principe	noble rank
principine	principe	noble rank
principini	principe	noble rank
principino	principe	noble rank
principessina	principessa	noble rank
principessine	principessa	noble rank
prioressa	priore	ecclesiastical occupation
prioresse	priore	ecclesiastical occupation
priori	priore	ecclesiastical occupation
procaccia	procaccia	profession
procuratora	procuratore	profession
procuratore	procuratore	profession
procuratoressa	procuratore	profession
procuratoresse	procuratore	profession
procuratori	procuratore	profession
procuratrice	procuratore	profession
procuratrici	procuratore	profession
produttora	produttore	profession
produttore	produttore	profession
produttori	produttore	profession
produttrice	produttore	profession
produttrici	produttore	profession
professora	professore	profession
professore	professore	profession
professoressa	professore	profession
professoresse	professore	profession
professori	professore	profession
professorina	professore	profession
professorine	professore	profession
professorini	professore	profession
professorino	professore	profession
professorona	professore	profession
professorone	professore	profession
professoroni	professore	profession
professorucce	professore	profession
professorucci	professore	profession
professoruccia	professore	profession
professoruccio	professore	profession
profeta	profeta	profession
profete	profeta	profession
profeti	profeta	profession
profetessa	profeta	profession
profumiera	profumiere	profession
profumiere	profumiere	profession
profumieri	profumiere	profession
progettista	progettista	profession
progettiste	progettista	profession
progettisti	progettista	profession
propagandista	propagandista	profession
propagandiste	propagandista	profession
propagandisti	propagandista	profession
prosatora	prosatore	profession
prosatore	prosatore	profession
prosatori	prosatore	profession
prosatrice	prosatore	profession
prosatrici	prosatore	profession
prosseneta	prosseneta	profession
prossenete	prosseneta	profession
prosseneti	prosseneta	profession
prostituta	prostituto	profession
prostitute	prostituto	profession
prostituti	prostituto	profession
prostituto	prostituto	profession
protonotarii	protonotario	profession
protonotari	protonotario	profession
protonotario	protonotario	profession
psichiatra	psichiatra	profession
psichiatre	psichiatra	profession
psichiatri	psichiatra	profession
psicologa	psicologo	profession
psicologhe	psicologo	profession
psicologi	psicologo	profession
psicologhi	psicologo	profession
psicologo	psicologo	profession
pubblicani	pubblicano	profession
pubblicano	pubblicano	profession
pubblicitaria	pubblicitario	profession
pubblicitarie	pubblicitario	profession
pubblicitarii	pubblicitario	profession
pubblicitari	pubblicitario	profession
pubblicitario	pubblicitario	profession
quartiermastri	quartiermastro	military rank
quartiermastro	quartiermastro	military rank
questora	questore	profession
questore	questore	profession
questoressa	questore	profession
questoresse	questore	profession
questori	questore	profession
questrice	questore	profession
questrici	questore	profession
raccomandatarii	raccomandatario	profession
raccomandatari	raccomandatario	profession
raccomandatario	raccomandatario	profession
radiotelegrafista	radiotelegrafista	profession
radiotelegrafiste	radiotelegrafista	profession
radiotelegrafisti	radiotelegrafista	profession
raffinatora	raffinatore	profession
raffinatore	raffinatore	profession
raffinatori	raffinatore	profession
raffinatrice	raffinatore	profession
raffinatrici	raffinatore	profession
ragioniera	ragioniere	profession
ragioniere	ragioniere	profession
ragionieri	ragioniere	profession
rammendatrice	rammendatrice	profession
rammendatrici	rammendatrice	profession
ranocchiai	ranocchiaio	profession
ranocchiaia	ranocchiaio	profession
ranocchiaie	ranocchiaio	profession
ranocchiaio	ranocchiaio	profession
ranocchiaj	ranocchiaio	profession
ranocchiaja	ranocchiaio	profession
ranocchiaje	ranocchiaio	profession
ranocchiaji	ranocchiaio	profession
ranocchiajo	ranocchiaio	profession
rappresentante	rappresentante	profession
rappresentanti	rappresentante	profession
rapsodi	rapsodo	profession
rapsodo	rapsodo	profession
re	re	noble rank
reclamista	reclamista	profession
reclamiste	reclamista	profession
reclamisti	reclamista	profession
recluta	recluta	military rank
reclute	recluta	military rank
recluti	recluta	military rank
reclutina	recluta	military rank
reclutine	recluta	military rank
reclutini	recluta	military rank
reclutino	recluta	military rank
recluto	recluta	military rank
redattora	redattore	profession
redattore	redattore	profession
redattori	redattore	profession
redattrice	redattore	profession
redattrici	redattore	profession
regens	regens	profession
reggente	reggente	profession
reggenti	reggente	profession
regina	regina	noble rank
regine	regina	noble rank
regista	regista	profession
registe	regista	profession
registi	regista	profession
restauratora	restauratore	profession
restauratore	restauratore	profession
restauratori	restauratore	profession
restauratrice	restauratore	profession
restauratrici	restauratore	profession
retora	retore	profession
retore	retore	profession
retori	retore	profession
retrice	retore	profession
retrici	retore	profession
rettora	rettore	ecclesiastical occupation
rettore	rettore	ecclesiastical occupation
rettoressa	rettore	ecclesiastical occupation
rettoresse	rettore	ecclesiastical occupation
rettori	rettore	ecclesiastical occupation
rettrice	rettore	ecclesiastical occupation
rettrici	rettore	ecclesiastical occupation
revisora	revisore	profession
revisore	revisore	profession
revisori	revisore	profession
reziarii	reziario	profession
reziario	reziario	profession
ricamatora	ricamatore	profession
ricamatore	ricamatore	profession
ricamatori	ricamatore	profession
ricamatrice	ricamatore	profession
ricamatrici	ricamatore	profession
ricercatora	ricercatore	profession
ricercatore	ricercatore	profession
ricercatori	ricercatore	profession
ricercatrice	ricercatore	profession
ricercatrici	ricercatore	profession
ricevitora	ricevitore	profession
ricevitore	ricevitore	profession
ricevitori	ricevitore	profession
ricevitrice	ricevitore	profession
ricevitrici	ricevitore	profession
rigattiera	rigattiere	profession
rigattiere	rigattiere	profession
rigattieri	rigattiere	profession
risaioli	risaiolo	profession
risaiolo	risaiolo	profession
risaiola	risaiolo	profession
risaiole	risaiolo	profession
risajoli	risaiolo	profession
risajolo	risaiolo	profession
risajola	risaiolo	profession
risajole	risaiolo	profession
ristoratora	ristoratore	profession
ristoratore	ristoratore	profession
ristoratori	ristoratore	profession
ristoratrice	ristoratore	profession
ristoratrici	ristoratore	profession
ritrattista	ritrattista	profession
ritrattiste	ritrattista	profession
ritrattisti	ritrattista	profession
rivenditora	rivenditore	profession
rivenditore	rivenditore	profession
rivenditori	rivenditore	profession
rivenditrice	rivenditore	profession
rivenditrici	rivenditore	profession
robivecchi	robivecchi	profession
romanziera	romanziere	profession
romanziere	romanziere	profession
romanzieri	romanziere	profession
sacrestani	sacrestano	profession
sacrestano	sacrestano	profession
sagrista	sagrista	profession
sagriste	sagrista	profession
sagristi	sagrista	profession
salariata	salariato	profession
salariate	salariato	profession
salariati	salariato	profession
salariato	salariato	profession
salesiani	salesiano	ecclesiastical occupation
salesiano	salesiano	ecclesiastical occupation
salumai	salumaio	profession
salumaia	salumaio	profession
salumaie	salumaio	profession
salumaio	salumaio	profession
salumaj	salumaio	profession
salumaja	salumaio	profession
salumaje	salumaio	profession
salumaji	salumaio	profession
salumajo	salumaio	profession
salumiera	salumiere	profession
salumiere	salumiere	profession
salumieri	salumiere	profession
samurai	samurai	profession
sarta	sarto	profession
sarte	sarto	profession
sarti	sarto	profession
sartina	sarto	profession
sartine	sarto	profession
sartini	sarto	profession
sartino	sarto	profession
sarto	sarto	profession
sartora	sartore	profession
sartore	sartore	profession
sartoressa	sartore	profession
sartoresse	sartore	profession
sartoretta	sartore	profession
sartorette	sartore	profession
sartoretti	sartore	profession
sartoretto	sartore	profession
sartori	sartore	profession
sartorina	sartore	profession
sartorine	sartore	profession
sartorini	sartore	profession
sartucce	sarto	profession
sartucci	sarto	profession
sartuccia	sarto	profession
sartuccio	sarto	profession
satrapi	satrapo	noble rank
satrapo	satrapo	noble rank
sbozzatora	sbozzatore	profession
sbozzatore	sbozzatore	profession
sbozzatori	sbozzatore	profession
sbozzatrice	sbozzatore	profession
sbozzatrici	sbozzatore	profession
scalchi	scalco	profession
scalco	scalco	profession
scalpellina	scalpellino	profession
scalpelline	scalpellino	profession
scalpellini	scalpellino	profession
scalpellino	scalpellino	profession
scaricatora	scaricatore	profession
scaricatore	scaricatore	profession
scaricatori	scaricatore	profession
scaricatrice	scaricatore	profession
scaricatrici	scaricatore	profession
scarpara	scarparo	profession
scarpare	scarparo	profession
scarpari	scarparo	profession
scarparo	scarparo	profession
scavatora	scavatore	profession
scavatore	scavatore	profession
scavatori	scavatore	profession
scavatrice	scavatore	profession
scavatrici	scavatore	profession
scenografa	scenografo	profession
scenografe	scenografo	profession
scenografi	scenografo	profession
scenografo	scenografo	profession
sceriffa	sceriffo	profession
sceriffe	sceriffo	profession
sceriffi	sceriffo	profession
sceriffo	sceriffo	profession
scienziata	scienziato	profession
scienziate	scienziato	profession
scienziati	scienziato	profession
scienziato	scienziato	profession
scolara	scolaro	profession
scolare	scolaro	profession
scolaretta	scolaro	profession
scolarette	scolaro	profession
scolaretti	scolaro	profession
scolaretto	scolaro	profession
scolari	scolaro	profession
scolarina	scolaro	profession
scolarine	scolaro	profession
scolarini	scolaro	profession
scolarino	scolaro	profession
scolaro	scolaro	profession
scolarucce	scolaro	profession
scolarucci	scolaro	profession
scolaruccia	scolaro	profession
scolaruccio	scolaro	profession
scolopii	scolopio	ecclesiastical occupation
scolopi	scolopio	ecclesiastical occupation
scolopio	scolopio	ecclesiastical occupation
scopina	scopino	profession
scopine	scopino	profession
scopini	scopino	profession
scopino	scopino	profession
scriba	scriba	profession
scribe	scriba	profession
scribi	scriba	profession
scrittora	scrittore	profession
scrittore	scrittore	profession
scrittori	scrittore	profession
scrittrice	scrittore	profession
scrittrici	scrittore	profession
scrivani	scrivano	profession
scrivano	scrivano	profession
scrivana	scrivano	profession
scrivane	scrivano	profession
scudiera	scudiero	profession
scudiere	scudiero	profession
scudieri	scudiero	profession
scudiero	scudiero	profession
scultora	scultore	profession
scultore	scultore	profession
scultori	scultore	profession
scultrice	scultore	profession
scultrici	scultore	profession
secondina	secondino	profession
secondine	secondino	profession
secondini	secondino	profession
secondino	secondino	profession
segantini	segantino	profession
segantino	segantino	profession
segretaria	segretario	profession
segretarie	segretario	profession
segretarii	segretario	profession
segretari	segretario	profession
segretario	segretario	profession
segretariucce	segretario	profession
segretariucci	segretario	profession
segretariuccia	segretario	profession
segretariuccio	segretario	profession
selciatora	selciatore	profession
selciatore	selciatore	profession
selciatori	selciatore	profession
selciatrice	selciatore	profession
selciatrici	selciatore	profession
sellai	sellaio	profession
sellaia	sellaio	profession
sellaie	sellaio	profession
sellaio	sellaio	profession
sellaj	sellaio	profession
sellaja	sellaio	profession
sellaje	sellaio	profession
sellaji	sellaio	profession
sellajo	sellaio	profession
seminarista	seminarista	ecclesiastical occupation
seminariste	seminarista	ecclesiastical occupation
seminaristi	seminarista	ecclesiastical occupation
semplicista	semplicista	profession
sempliciste	semplicista	profession
semplicisti	semplicista	profession
senatora	senatore	profession
senatore	senatore	profession
senatoressa	senatore	profession
senatoresse	senatore	profession
senatori	senatore	profession
senatrice	senatore	profession
senatrici	senatore	profession
seniora	seniore	military rank
seniore	seniore	military rank
seniori	seniore	military rank
sentinella	sentinella	profession
sentinelle	sentinella	profession
sergente	sergente	military rank
sergenti	sergente	military rank
sergentini	sergente	military rank
sergentino	sergente	military rank
sergentone	sergente	military rank
sergentoni	sergente	military rank
servetta	servetta	profession
servette	servetta	profession
servetti	servetta	profession
servetto	servetta	profession
servina	servo	profession
servine	servo	profession
servini	servo	profession
servino	servo	profession
servitora	servitore	profession
servitore	servitore	profession
servitoressa	servitore	profession
servitoresse	servitore	profession
servitori	servitore	profession
servitorina	servitore	profession
servitorine	servitore	profession
servitorini	servitore	profession
servitorino	servitore	profession
servitorucce	servitore	profession
servitorucci	servitore	profession
servitoruccia	servitore	profession
servitoruccio	servitore	profession
servitrice	servitore	profession
servitrice	servitrice	profession
servitrici	servitore	profession
servitrici	servitrice	profession
servona	servetta	profession
servone	servetta	profession
servoni	servetta	profession
servucce	servetta	profession
servucci	servetta	profession
servuccia	servetta	profession
setaiuola	setaiuolo	profession
setaiuole	setaiuolo	profession
setaiuoli	setaiuolo	profession
setaiuolo	setaiuolo	profession
setajuola	setaiuolo	profession
setajuole	setaiuolo	profession
setajuoli	setaiuolo	profession
setajuolo	setaiuolo	profession
sguattera	sguattero	profession
sguattere	sguattero	profession
sguatteri	sguattero	profession
sguattero	sguattero	profession
sicarii	sicario	profession
sicari	sicario	profession
sicario	sicario	profession
sigarai	sigaraio	profession
sigaraia	sigaraio	profession
sigaraie	sigaraio	profession
sigaraio	sigaraio	profession
sigaraj	sigaraio	profession
sigaraja	sigaraio	profession
sigaraje	sigaraio	profession
sigaraji	sigaraio	profession
sigarajo	sigaraio	profession
sindaca	sindaco	profession
sindache	sindaco	profession
sindachessa	sindaco	profession
sindachesse	sindaco	profession
sindaci	sindaco	profession
sindaco	sindaco	profession
siniscalchi	siniscalco	profession
siniscalco	siniscalco	profession
sociologa	sociologo	profession
sociologhe	sociologo	profession
sociologi	sociologo	profession
sociologhi	sociologo	profession
sociologo	sociologo	profession
sofista	sofista	profession
sofiste	sofista	profession
sofisti	sofista	profession
soldatessa	soldato	military rank
soldata	soldato	military rank
soldati	soldato	military rank
soldatina	soldato	military rank
soldatine	soldato	military rank
soldatini	soldato	military rank
soldatino	soldato	military rank
soldato	soldato	military rank
soldatona	soldato	military rank
soldatone	soldato	military rank
soldatoni	soldato	military rank
soldatucce	soldato	military rank
soldatucci	soldato	military rank
soldatuccia	soldato	military rank
soldatuccio	soldato	military rank
solista	solista	profession
soliste	solista	profession
solisti	solista	profession
sonatora	sonatore	profession
sonatore	sonatore	profession
sonatori	sonatore	profession
sonatrice	sonatore	profession
sonatrici	sonatore	profession
sorbettiera	sorbettiere	profession
sorbettiere	sorbettiere	profession
sorbettieri	sorbettiere	profession
sorvegliante	sorvegliante	profession
sorveglianti	sorvegliante	profession
sottoprefetta	sottoprefetto	profession
sottoprefette	sottoprefetto	profession
sottoprefetti	sottoprefetto	profession
sottoprefetto	sottoprefetto	profession
sottopriora	sottopriore	ecclesiastical occupation
sottopriore	sottopriore	ecclesiastical occupation
sottoprioressa	sottopriore	ecclesiastical occupation
sottoprioresse	sottopriore	ecclesiastical occupation
sottopriori	sottopriore	ecclesiastical occupation
sottotenente	sottotenente	military rank
sottotenenti	sottotenente	military rank
sottotenentina	sottotenente	military rank
sottotenentine	sottotenente	military rank
sottotenentini	sottotenente	military rank
sottotenentino	sottotenente	military rank
sottufficiale	sottufficiale	military rank
sottufficiali	sottufficiale	military rank
soubrette	soubrette	profession
soubrettes	soubrette	profession
sovrintendente	sovrintendente	profession
sovrintendenti	sovrintendente	profession
spaccalegna	spaccalegna	profession
spaccalegne	spaccalegna	profession
spaccapietre	spaccapietre	profession
spacciatora	spacciatore	profession
spacciatore	spacciatore	profession
spacciatori	spacciatore	profession
spacciatrice	spacciatore	profession
spacciatrici	spacciatore	profession
spadai	spadaio	profession
spadaia	spadaio	profession
spadaie	spadaio	profession
spadaio	spadaio	profession
spadaj	spadaio	profession
spadaja	spadaio	profession
spadaje	spadaio	profession
spadaji	spadaio	profession
spadajo	spadaio	profession
spazzacamini	spazzacamino	profession
spazzacamino	spazzacamino	profession
spazzaturai	spazzaturaio	profession
spazzaturaia	spazzaturaio	profession
spazzaturaie	spazzaturaio	profession
spazzaturaio	spazzaturaio	profession
spazzaturaj	spazzaturaio	profession
spazzaturaja	spazzaturaio	profession
spazzaturaje	spazzaturaio	profession
spazzaturaji	spazzaturaio	profession
spazzaturajo	spazzaturaio	profession
spazzini	spazzino	profession
spazzino	spazzino	profession
sperimentatora	sperimentatore	profession
sperimentatore	sperimentatore	profession
sperimentatori	sperimentatore	profession
sperimentatrice	sperimentatore	profession
sperimentatrici	sperimentatore	profession
speziale	speziale	profession
speziali	speziale	profession
spia	spia	profession
spie	spia	profession
staffiera	staffiere	profession
staffiere	staffiere	profession
staffieri	staffiere	profession
stagnina	stagnino	profession
stagnine	stagnino	profession
stagnini	stagnino	profession
stagnino	stagnino	profession
stalliera	stalliere	profession
stalliere	stalliere	profession
stallieri	stalliere	profession
stampatora	stampatore	profession
stampatore	stampatore	profession
stampatori	stampatore	profession
stampatrice	stampatore	profession
stampatrici	stampatore	profession
statista	statista	profession
statiste	statista	profession
statisti	statista	profession
statistici	statistico	profession
statistico	statistico	profession
stenografa	stenografo	profession
stenografe	stenografo	profession
stenografi	stenografo	profession
stenografo	stenografo	profession
sterratora	sterratore	profession
sterratore	sterratore	profession
sterratori	sterratore	profession
sterratrice	sterratore	profession
sterratrici	sterratore	profession
stilista	stilista	profession
stiliste	stilista	profession
stilisti	stilista	profession
stilita	stilita	ecclesiastical occupation
stilite	stilita	ecclesiastical occupation
stiliti	stilita	ecclesiastical occupation
stiratora	stiratore	profession
stiratore	stiratore	profession
stiratori	stiratore	profession
stiratrice	stiratore	profession
stiratrice	stiratrice	profession
stiratrici	stiratore	profession
stiratrici	stiratrice	profession
stivatora	stivatore	profession
stivatore	stivatore	profession
stivatori	stivatore	profession
stivatrice	stivatore	profession
stivatrici	stivatore	profession
storiografa	storiografo	profession
storiografe	storiografo	profession
storiografi	storiografo	profession
storiografo	storiografo	profession
stracciarola	stracciarolo	profession
stracciarole	stracciarolo	profession
stracciaroli	stracciarolo	profession
stracciarolo	stracciarolo	profession
straccivendoli	straccivendolo	profession
straccivendolo	straccivendolo	profession
stradini	stradino	profession
stradino	stradino	profession
stradioti	stradioti	profession
strateghi	stratego	military rank
stratego	stratego	military rank
stratega	stratego	military rank
strillona	strillone	profession
strillone	strillone	profession
strilloni	strillone	profession
strumentista	strumentista	profession
strumentiste	strumentista	profession
strumentisti	strumentista	profession
stuccatora	stuccatore	profession
stuccatore	stuccatore	profession
stuccatori	stuccatore	profession
stuccatrice	stuccatore	profession
stuccatrici	stuccatore	profession
studiosa	studioso	profession
studiose	studioso	profession
studiosi	studioso	profession
studioso	studioso	profession
suddiaconi	suddiacono	ecclesiastical occupation
suddiacono	suddiacono	ecclesiastical occupation
sultana	sultano	noble rank
sultane	sultano	noble rank
sultanetta	sultano	noble rank
sultanette	sultano	noble rank
sultanetti	sultano	noble rank
sultanetto	sultano	noble rank
sultani	sultano	noble rank
sultano	sultano	noble rank
suonatora	suonatore	profession
suonatore	suonatore	profession
suonatori	suonatore	profession
suonatrice	suonatore	profession
suonatrici	suonatore	profession
suora	suora	ecclesiastical occupation
suore	suora	ecclesiastical occupation
suoretta	suora	ecclesiastical occupation
suorette	suora	ecclesiastical occupation
suoretti	suora	ecclesiastical occupation
suorina	suora	ecclesiastical occupation
suorine	suora	ecclesiastical occupation
suoraccia	suora	ecclesiastical occupation
suoracce	suora	ecclesiastical occupation
supplente	supplente	profession
supplenti	supplente	profession
tabaccai	tabaccaio	profession
tabaccaia	tabaccaio	profession
tabaccaie	tabaccaio	profession
tabaccaio	tabaccaio	profession
tabaccaj	tabaccaio	profession
tabaccaja	tabaccaio	profession
tabaccaje	tabaccaio	profession
tabaccaji	tabaccaio	profession
tabaccajo	tabaccaio	profession
tabacchini	tabacchino	profession
tabacchino	tabacchino	profession
tabellione	tabellione	profession
tabellioni	tabellione	profession
tagliaboschi	tagliaboschi	profession
taglialegna	taglialegna	profession
tagliapietre	tagliapietre	profession
tagliatora	tagliatore	profession
tagliatore	tagliatore	profession
tagliatori	tagliatore	profession
tagliatrice	tagliatore	profession
tagliatrici	tagliatore	profession
tamburina	tamburino	military rank
tamburine	tamburino	military rank
tamburini	tamburino	military rank
tamburino	tamburino	military rank
tappezziera	tappezziere	profession
tappezziere	tappezziere	profession
tappezzieri	tappezziere	profession
tarenti	tarento	profession
tarentina	tarento	profession
tarentine	tarento	profession
tarentini	tarento	profession
tarentino	tarento	profession
tarento	tarento	profession
tassista	tassista	profession
tassiste	tassista	profession
tassisti	tassista	profession
taverniera	taverniere	profession
taverniere	taverniere	profession
tavernieri	taverniere	profession
telefonista	telefonista	profession
telefoniste	telefonista	profession
telefonisti	telefonista	profession
telegrafista	telegrafista	profession
telegrafiste	telegrafista	profession
telegrafisti	telegrafista	profession
tenente	tenente	military rank
tenenti	tenente	military rank
tenentina	tenente	military rank
tenentine	tenente	military rank
tenentini	tenente	military rank
tenentino	tenente	military rank
teologa	teologo	profession
teologhe	teologo	profession
teologi	teologo	profession
teologhi	teologo	profession
teologo	teologo	profession
teosofi	teosofo	profession
teosofo	teosofo	profession
terapeuta	terapeuta	profession
terapeute	terapeuta	profession
terapeuti	terapeuta	profession
terrazziera	terrazziere	profession
terrazziere	terrazziere	profession
terrazzieri	terrazziere	profession
tesoriera	tesoriere	profession
tesoriere	tesoriere	profession
tesorieri	tesoriere	profession
tessitora	tessitore	profession
tessitore	tessitore	profession
tessitori	tessitore	profession
tessitorina	tessitore	profession
tessitorine	tessitore	profession
tessitorini	tessitore	profession
tessitrice	tessitore	profession
tessitrici	tessitore	profession
tetrarca	tetrarca	profession
tetrarche	tetrarca	profession
tetrarchi	tetrarca	profession
timoniera	timoniere	profession
timoniere	timoniere	profession
timonieri	timoniere	profession
tintora	tintore	profession
tintore	tintore	profession
tintoretta	tintore	profession
tintorette	tintore	profession
tintoretti	tintore	profession
tintoretto	tintore	profession
tintori	tintore	profession
tintrice	tintore	profession
tintrici	tintore	profession
tipografa	tipografo	profession
tipografe	tipografo	profession
tipografi	tipografo	profession
tipografo	tipografo	profession
tiratora	tiratore	profession
tiratore	tiratore	profession
tiratori	tiratore	profession
tiratrice	tiratore	profession
tiratrici	tiratore	profession
topografa	topografo	profession
topografe	topografo	profession
topografi	topografo	profession
topografo	topografo	profession
torcoliera	torcoliere	profession
torcoliere	torcoliere	profession
torcolieri	torcoliere	profession
toreri	torero	profession
torero	torero	profession
tornitora	tornitore	profession
tornitore	tornitore	profession
tornitori	tornitore	profession
tornitrice	tornitore	profession
tornitrici	tornitore	profession
tosacani	tosacani	profession
traduttora	traduttore	profession
traduttore	traduttore	profession
traduttori	traduttore	profession
traduttrice	traduttore	profession
traduttrici	traduttore	profession
trafficante	trafficante	profession
trafficanti	trafficante	profession
traghettatora	traghettatore	profession
traghettatore	traghettatore	profession
traghettatori	traghettatore	profession
traghettatrice	traghettatore	profession
traghettatrici	traghettatore	profession
tranviera	tranviere	profession
tranviere	tranviere	profession
tranvieri	tranviere	profession
trasformista	trasformista	profession
trasformiste	trasformista	profession
trasformisti	trasformista	profession
trattora	trattore	profession
trattore	trattore	profession
trattori	trattore	profession
trattrice	trattore	profession
trattrici	trattore	profession
trebbiatora	trebbiatore	profession
trebbiatore	trebbiatore	profession
trebbiatori	trebbiatore	profession
trebbiatrice	trebbiatore	profession
trebbiatrici	trebbiatore	profession
trecciaiola	trecciaiolo	profession
trecciaiole	trecciaiolo	profession
trecciaioli	trecciaiolo	profession
trecciaiolo	trecciaiolo	profession
tribuni	tribuno	military rank
tribuno	tribuno	military rank
trinciante	trinciante	profession
trincianti	trinciante	profession
trombettiera	trombettiere	military rank
trombettiere	trombettiere	military rank
trombettieri	trombettiere	military rank
trovarobe	trovarobe	profession
trovatora	trovatore	profession
trovatore	trovatore	profession
trovatori	trovatore	profession
trovatrice	trovatore	profession
trovatrici	trovatore	profession
trovieri	troviero	profession
troviero	troviero	profession
tutora	tutore	profession
tutore	tutore	profession
tutoressa	tutore	profession
tutoresse	tutore	profession
tutori	tutore	profession
tutrice	tutore	profession
tutrici	tutore	profession
uccellatora	uccellatore	profession
uccellatore	uccellatore	profession
uccellatori	uccellatore	profession
uccellatrice	uccellatore	profession
uccellatrici	uccellatore	profession
ufficiale	ufficiale	military rank
ufficiali	ufficiale	military rank
umorista	umorista	profession
umoriste	umorista	profession
umoristi	umorista	profession
usciera	usciere	profession
usciere	usciere	profession
uscieri	usciere	profession
usurai	usuraio	profession
usuraia	usuraio	profession
usuraie	usuraio	profession
usuraio	usuraio	profession
usuraj	usuraio	profession
usuraja	usuraio	profession
usuraje	usuraio	profession
usuraji	usuraio	profession
usurajo	usuraio	profession
vaccai	vaccaio	profession
vaccaia	vaccaio	profession
vaccaie	vaccaio	profession
vaccaio	vaccaio	profession
vaccaj	vaccaio	profession
vaccaja	vaccaio	profession
vaccaje	vaccaio	profession
vaccaji	vaccaio	profession
vaccajo	vaccaio	profession
vaccari	vaccaro	profession
vaccarina	vaccaro	profession
vaccarine	vaccaro	profession
vaccarini	vaccaro	profession
vaccarino	vaccaro	profession
vaccaro	vaccaro	profession
vaccinari	vaccinaro	profession
vaccinaro	vaccinaro	profession
valletti	valletto	profession
valletto	valletto	profession
valvassora	valvassore	noble rank
valvassore	valvassore	noble rank
valvassori	valvassore	noble rank
vasai	vasaio	profession
vasaia	vasaio	profession
vasaie	vasaio	profession
vasaio	vasaio	profession
vasaj	vasaio	profession
vasaja	vasaio	profession
vasaje	vasaio	profession
vasaji	vasaio	profession
vasajo	vasaio	profession
venditora	venditore	profession
venditore	venditore	profession
venditori	venditore	profession
venditrice	venditore	profession
venditrici	venditore	profession
ventriloqui	ventriloquo	profession
ventriloquo	ventriloquo	profession
vergai	vergaio	profession
vergaia	vergaio	profession
vergaie	vergaio	profession
vergaio	vergaio	profession
vergaj	vergaio	profession
vergaja	vergaio	profession
vergaje	vergaio	profession
vergaji	vergaio	profession
vergajo	vergaio	profession
vergara	vergaro	profession
vergare	vergaro	profession
vergari	vergaro	profession
vergaro	vergaro	profession
verniciatora	verniciatore	profession
verniciatore	verniciatore	profession
verniciatori	verniciatore	profession
verniciatrice	verniciatore	profession
verniciatrici	verniciatore	profession
vescovi	vescovo	ecclesiastical occupation
vescovo	vescovo	ecclesiastical occupation
veterinaria	veterinario	profession
veterinarie	veterinario	profession
veterinarii	veterinario	profession
veterinari	veterinario	profession
veterinario	veterinario	profession
vetrai	vetraio	profession
vetraia	vetraio	profession
vetraie	vetraio	profession
vetraio	vetraio	profession
vetraj	vetraio	profession
vetraja	vetraio	profession
vetraje	vetraio	profession
vetraji	vetraio	profession
vetrajo	vetraio	profession
vetturina	vetturino	profession
vetturine	vetturino	profession
vetturini	vetturino	profession
vetturino	vetturino	profession
vicaria	vicario	ecclesiastical occupation
vicarie	vicario	ecclesiastical occupation
vicarii	vicario	ecclesiastical occupation
vicario	vicario	ecclesiastical occupation
vignaioli	vignaiolo	profession
vignaiolo	vignaiolo	profession
vignajoli	vignaiolo	profession
vignajolo	vignaiolo	profession
vignaiole	vignaiolo	profession
vignaiola	vignaiolo	profession
vignajole	vignaiolo	profession
vignajola	vignaiolo	profession
vinai	vinaio	profession
vinaia	vinaio	profession
vinaie	vinaio	profession
vinaio	vinaio	profession
vinaj	vinaio	profession
vinaja	vinaio	profession
vinaje	vinaio	profession
vinaji	vinaio	profession
vinajo	vinaio	profession
vinattiera	vinattiere	profession
vinattiere	vinattiere	profession
vinattieri	vinattiere	profession
violinista	violinista	profession
violiniste	violinista	profession
violinisti	violinista	profession
violoncellista	violoncellista	profession
violoncelliste	violoncellista	profession
violoncellisti	violoncellista	profession
visconte	visconte	noble rank
visconti	visconte	noble rank
viscontina	visconte	noble rank
viscontine	visconte	noble rank
viscontini	visconte	noble rank
viscontino	visconte	noble rank
viscontessa	viscontessa	noble rank
viscontesse	viscontessa	noble rank
viscontessina	viscontessa	noble rank
viscontessine	viscontessa	noble rank
visdomini	visdomino	noble rank
visdomino	visdomino	noble rank
viticultora	viticultore	profession
viticultore	viticultore	profession
viticultori	viticultore	profession
viticultrice	viticultore	profession
viticultrici	viticultore	profession
vivandiera	vivandiere	profession
vivandiere	vivandiere	profession
vivandieri	vivandiere	profession
vladika	vladika	ecclesiastical occupation
vladike	vladika	ecclesiastical occupation
vladiki	vladika	ecclesiastical occupation
vogatora	vogatore	profession
vogatore	vogatore	profession
vogatori	vogatore	profession
vogatrice	vogatore	profession
vogatrici	vogatore	profession
zampognari	zampognaro	profession
zampognaro	zampognaro	profession
zampognara	zampognaro	profession
zampognare	zampognaro	profession
zappaterra	zappaterra	profession
zappatora	zappatore	profession
zappatore	zappatore	profession
zappatori	zappatore	profession
zappatrice	zappatore	profession
zappatrici	zappatore	profession
zarina	zarina	noble rank
zarine	zarina	noble rank
zar	zar	noble rank
zoologa	zoologo	profession
zoologhe	zoologo	profession
zoologi	zoologo	profession
zoologhi	zoologo	profession
zoologo	zoologo	profession
